(eemale, ära) ajama	гнать
(sita) junn	говёшка
aabits	азбука
aabits	букварь
Aadam	Адам
äädikas	уксус
aadress	адрес
aadressiraamat	адресная книга
Aafrika	Африка
aafrika	африканский
aafriklane	африканец
aafriklanna	африканка
aaloe	алоэ
äär	край
aarded	сокровища
ääred	поля (на странице)
äärelinn	окраина (города)
Aasia	Азия
aasialik	азиатский
aasta	год
aasta pärast	через год
aasta tagasi	год назад
aastaaeg	время года
aastapäev	годовщина
aatomipomm	атомная бомба
abee	аббат
abi	подмога
abi	помощь
abielu	брак
abielu	брак (семейная жизнь)
abielupaar	пара,чета
abielus	женатый
abielus	замужняя
abikaasa	супруг
abikaasa	супруга
abikaasa (mees)	муж
abikaasa (mees)	супруг
abikaasa (naine)	жена
abikaasa (naine)	супруга
abonent	абонент
abordaaž	абордаж
abort	аборт
abstraktsionism	абстракционизм
abtkond	аббатство
administraator	администратор
admiral	адмирал
advokaat	адвокат
aed	сад
aedmaasikas	клубника
aednik	садовник
aedoad	фасоль
aeg	время
aeglane	медленный
aeglaselt	медленно
aer	весло
aeroobika	аэробика
aevastama	чихать
Afganistan	Афганистан
agentuur	агентство
agressioon	агрессия
agronoom	агроном
ahi	печь (предмет)
ahjupuud	дрова
ähmane	тусклый (о свете)
ahne	жадный (скупой)
ahnus	жадность (скупость)
ahter	корма
ahv	обезьяна
ähvardama	угрожать
ahven	окунь
ahvileivapuu	баобаб
äi	свёкор
aiamaa	огород
aiavärav	калитка
AIDS	СПИД
äike	гроза
aimama	предчувствовать
aimefilm	фантастический фильм
aimekirjandus	научная фантастика
aimekirjandus	фантастика (научная)
aine	вещество
ainulaadne	уникальный
ainult	только
ait	амбар
aitab!	хватит!
aitama	помогать
aitama	помочь
aj uvap ustus	сотрясение мозга
ajajärk	эра
ajakiri	журнал
ajakirjanik	журналист
ajaleht	газета
ajaloolane	историк
ajalugu	история
ajastu	эпоха
ajavahemik	отрезок (времени)
aju	мозг
ajutine	временный
akaatsia	акация
akadeemia	академия
aken	окно
äkki	вдруг
akna juures	у окна
akordion	аккордеон
akrobaat	акробат
akrobaatika	акробатика
aksioom	аксиома
akt vaheaeg	акт, действие антракт
aktsendiga	с акцентом
aktsent	акцент
aktsia	акция
aktsiate kurss	курс акций
aku	аккумулятор
akvaarium	аквариум
akvalang	акваланг
akvarell	акварель (краска)
ala	вид (напр. спорта)
ala	местность
alahindama	недооценивать
alaline	постоянный (работа, адрес)
alandama	унижать
alandus	унижение
alandust taluma	унижаться
alasti	голый
alates	начиная
alati	всегда
alatiseks	навсегда
Albaania	Албания
albaania	албанский
albaanlane	албанец
albaanlanna	албанка
albatross	альбатрос
algaja	чайник
algama	начинаться
algatus	начинание
algebra	алгебра
algupärane	оригинальный
algus	начало
alguses	вначале
alibi	алиби
alkoholism	алкоголизм
alkohoolik	алкоголик
all	под
all	под (внизу)
alla jääma	уступать (в чём-л.)
alla kriipsutama	подчеркнуть
alla laadima	загружать
alla laskma	опускать
alla nulli	ниже нуля
Allah	Аллах
allahindlus	скидка
allalaadimine	скачать (скопировать)
allavoolu	вниз по течению
allee	аллея
allergia	аллергия
alles hoidma	хранить (старые письма)
allikas	источник, родник
allkiri	подпись
allkiri allkirjastama	подпись подписать
allkirjastama	подписать
allkirjastama	подписывать
alluma	подчиниться
alluv	подчинённый (сущ.)
allveelaev	лодка подводная
allveelaev	подводная лодка
allveeujumine	дайвинг
Alpid	Альпы
alpinism	альпинизм
alpinist	альпинист
Altai	Алтай
alumiinium	алюминий
alumiinium-	алюминиевый
alus	подлежащее (лингв.)
alussärk	майка
alustama	начинать
alustass	блюдце
ämber	ведро
ämblik	паук
ämblikuvõrk	паутина
Ambur	Стрелец
Ameerika	Америка
ameerika	американский
ameerika jalgpall	американский футбол
Ameerika Ühendriigid	Соединённые Штаты
ameeriklane	американец
ameeriklanna	американка
ametlik visiit	официальный визит
ametnik	чиновник
ämm	тёща
ämm (meheema)	свекровь
ammu	давно
ammu enne	задолго до ...
ammuma	мычать
amnestia	амнистия
amortisaator	амортизатор
amper	ампер
ampull	ампула
amputeerima	ампутировать
amputeerimine	ампутация
Amsterdam	Амстердам
anakonda	анаконда
analüüs	анализ
analüüsima	анализировать
ananass	ананас
anastaja	захватчик
anastama	захватить
anastama	захватывать
andekas	талантливый
andeks andma	прощать
andeks paluma	просить прощения
andestama	простить
andestama	прощать
Andid	Анды
andma	давать
andma	дать
andmebaas	база данных
andmed	данные
andmed	сведения
andur	датчик
anekdoot	анекдот
angerjas	угорь
angiin	ангина
anglikaan	англиканин
anglikaani kirik	Англиканская церковь
aniis	анис
animafilm	мультфильм
Ankara	Анкара
ankeet	анкета
ankrukett	якорная цепь
ankur	якорь
ankur sisse	поднять якорь
ankur välja	бросить якорь
anna teed	уступи дорогу
anne	талант
Antarktis Arktika	Антарктида Арктика
antenn	антенна
antikvariaat	антиквариат
antiloop	антилопа
antonüüm	антоним
anuma	умолять (просить)
äpardus	неудача (провал)
apelsin	апельсин
apenditsiit	аппендицит
aplaus	аплодисменты
aplodeerima	хлопать (артистам)
apostel	апостол
apostroof	апостроф
aprikoos	абрикос
aprill	апрель
apteek	аптека
ära ajama	прогнать (кого-л.)
ära andma	предать
ära arvama	отгадать
ära eksima	заблудиться
ära jätma	отменить
ära kaduma	исчезнуть
ära kaduma	потеряться
ära koristama	убирать (в шкаф и т.п.)
ära koristama	убирать (спрятать)
ära kuulama	выслушать
ära lendama	улететь (о птице)
ära lõikama	отрезать
ära lööma	удариться
ära määrima	испачкаться
ära märkima	отметить (на карте и т.п.)
ära põletama	жечь, сжигать
ära raiuma	отрубить
ära rebima	оторвать
ära tundma	узнавать (кого-л.)
ära viima	уносить
ära võtma	отнять (деньги и т.п.)
araabia	арабский
Araabia Ühendemiraadid	Объединённые Арабские Эмираты
araablane	араб
araablanna	арабка
äraandja	предатель
ärajätmine	отмена
ärakiri	копия
äratama	разбудить
äratuskell	будильник
arbalett	арбалет
arbuus	арбуз
areen	арена
arendaja	разработчик
arendama	развивать
areng	развитие
arest	арест
arg	трусливый
Argentiina	Аргентина
argentiina	аргентинский
argentiinlane	аргентинец
argentiinlanna	аргентинка
argpüks	трус
argument	аргумент
arheoloog	археолог
arheoloogia	археология
arheoloogiline	а рхеол огически й
arhiiv	архив
arhipelaag	архипелаг
arhitekt	архитектор
arhitektuur	архитектура
ärikeskus	бизнес-центр
ärkama	просыпаться
arm	шрам
armas	милый (любезный)
armastama	любить
armastama	любить (кого-л.)
armastama	любить (напр. спорт)
armastama	любить (человека)
armastus	любовь
armastusväärne	любезный
armatuur	арматура
armatuurlaud	приборный щиток
armukade	ревнивый
armukadetsema	ревновать
armuke	любовник
armuke	любовница
armuma	влюбиться (в ...)
arreteerima	арестовать
ärritama	раздражать
ärritama	сердить
ärrituma	раздражаться
arst	врач
arter	артерия
artikkel	статья
artišokk	артишок
artriit	артрит
ärtu	червы
aru	разум
aru saama	понимать
aruanne	отчёт
arusaadav	понятный (ясный)
arusaamatu	непонятный (~ текст)
arusaamatu	неясный
arusaamatus	недоразумение
arutama	обсуждать
arutelu	обсуждение
arvama	считать (думать)
arvamus	мнение
arve	счёт (в бизнесе)
arve	счёт (в ресторане)
arvele panema	положить на счёт
arvelt võtma	снять со счёта
arvestama	рассчитывать на ...
arvesti	электросчётчик
arvestus	расчёт (прибыли и т.п.)
arvuti	компьютер
arvutispetsialist	компьютерщик
asemele	взамен
asepresident	вице-президент
asesõna	местоимение
asetäitja	заместитель
asetama	положить
asetama	постав
asfalt	асфальт
asi	вещь
asi	дело (занятие)
asi, ese	вещь
asjad	вещи
asjaolu	обстоятельство
aspar	спаржа
äss	туз
assistent	ассистент
assotsiatsioon	ассоциация
aste	степень
asteroid	астероид
astma	астма
astmed	ступени
astronaut	астронавт
astronoom	астроном
astronoomia	астрономия
Ateena	Афины
ateism	атеизм
ateist	атеист
ateljee	ателье
ateljee	мастерская
ateroskleroos	атеросклероз
Atlandi ookean	Атлантический океан
atlas	атлас
atleet	атлет
atleet	атлет (силач)
atmosfäär	атмосфера
atoll	атолл
audititeenused	аудиторские услуги
auditoorium	аудитория (помещение)
auguraud	дырокол
august	август
auhind	приз
auk	дыра
auk	лунка
auk	прокол
auk	яма
aurik	пароход
aus	честный
austaja	поклонник
austama	уважать
austatud	уважаемый
auster	устрица
austerlane	австриец
austerlanna	австрийка
austraalia	австралийский
Austraalia	Австралия
austraallane	австралиец
austraallanna	австралийка
austria	австрийский
Austria	Австрия
austus	уважение
ausus	честность
autasu	награда (медаль и т.п.)
autasustama	наградить (~ медалью)
autasustama	награждать
auto	автомобиль
autoga	на автомобиле
autogramm	автограф
autojuht	водитель
autojuht	шофёр
automaat	автомат
automaatne	автоматический
automaatvastaja	автоответчик
autonumber	номер (авто)
autoportree	автопортрет
autor	автор
autoremonditöökoda	автосервис
autovõidusõit	автогонки
aval	открытый (человек)
avalik	публичный
avama	открывать
avama	открывать (банку и т.п.)
avama	открыть
avameelne	откровенный
avameelselt	откровенно
avar	просторный
avarii	авария
avariikolmnurk	аварийный треугольник
avariituled	аварийные огни
avastama	обнаружить
avastama	открывать (новые земли)
avastama	открыть
avastus	открытие (в науке)
avatud	открытый
avokaado	авокадо
baar	бар
baarimees	бармен
baas	база (основа)
Bagdad	Багдад
Bahama saared	Багамские острова
bait	байт
bakenbardid	бакенбарды
baklažaan	баклажан
bakter	бактерия
ballett	балет
banaan	банан
bandiit	бандит
Bangkok	Бангкок
Bangladesh	Бангладеш
baptism	Баптизм
baptist	баптист
barbar	варвары
Barcelona	Барселона
Barentsi meri Kara meri	Баренцево море Карское море
barett	берет
baromeeter	барометр
basiilik	базилик
bassein	бассейн
bassein	бассейн (реки)
basset	бассет
beez	беж
beež	бежевый
Beirut	Бейрут
belgia	бельгийский
Belgia	Бельгия
belglane	бельгиец
belglanna	бельгийка
bensiini	бензиновый
bensiiniauto	бензовоз
bensiinipaak	бензобак
Berliin	Берлин
bernhardiin	сенбернар
betoon	бетон
biifsteek	бифштекс
biitseps	бицепс
bilanss	баланс
binokkel	бинокль
bioloogia	биология
blondiin	блондин
blondiin	блондинка
bluus	блюз
boamadu	удав
bobisõit	бобслей
bodybilding	бодибилдинг
bokser	боксёр
Boliivia	Боливия
Bombay	Бомбей
Bonn	Бонн
Bordeaux	Бордо
börs	биржа
boss	босс
Brasiilia	Бразилия
brasiilia	бразильский
brasiillane	бразилец
brasiillanna	бразильянка
Bratislava	Братислава
brauser	браузер
brigaad	бригада
brigadir	бригадир
brigantiin	бригантина
briljant	бриллиант
brokkoli	капуста брокколи
bronhiit	бронхит
brošüür	брошюра
brünett	брюнет
brünett	брюнетка
Brüssel	Брюссель
brüsseli kapsas	брюссельская капуста
Budapest	Будапешт
budism	Буддизм
budist	буддист
Bukarest	Бухарест
buklett	буклет
buldog	бульдог
buldooser	бульдозер
Bulgaaria	Болгария
bulgaaria	болгарский
bulgaarlane	болгарин
bulgaarlanna	болгарка
bülletään	бюллетень
bürokraat	бюрократ
buss	автобус
Bütsants	Византия
bütsantsi	византийский
bütsantslased	византийцы
CD-mängija	CD-проигрыватель
CD-plaat	CD, компакт-диск
CD-plaat	компакт-диск
Chicago	Чикаго
daam	дама
daamide	дамский
Dalmaatsia koer	далматинец
Dar Es Salaam	Дар-эс-Салам
dattel	финик
deemon	демон
deklaratsioon	таможенная декларация
deklaratsiooni täitma	заполнить декларацию
dekoratsioonid	декорация
delegatsioon	делегация
delfiin	дельфин
delfinaarium	дельфинарий
Delhi	Дели
demokraat	демократ
demokraatia	демократия
demokraatlik	демократический
demokraatlik erakond	демократическая партия
demonstrant	демонстрант
demonstratsioon	демонстрация
demonstreerima	демонстрировать
depressioon	депрессия
deserteerima	дезертировать
desertöör	дезертир
dessantväelane	десантник
detail	деталь
detektiiv	детектив, сыщик
detektiiv	сыщик
detsember	декабрь
devalvatsioon	девальвация
diabeet	диабет
diagnoos	диагноз
dialoog	диалог
diameeter	диаметр
dieet	диета
diisel	дизельный
diivan	диван
diivanilaud	журнальный столик
diktaator	диктатор
diktor	диктор
dilemma	дилемма
diplom	диплом
diplomaat	дипломат
direktor	директор
dirigent	дирижёр
disain	дизайн
disainer	дизайнер
disko	дискотека
diskussioon	дискуссия
diskvalifitseerima	дисквалифицировать
dispetšer	диспетчер
divisjon	дивизия
dobermann	доберман
dogma	догма
doktriin	доктрина
dokumendid	документация
dokument	документ
dollar	доллар
Dominikaani Vabariik	Доминиканская республика
Don	Дон
Doonau	Дунай
doping	допинг
draakon	дракон
draama	драма
dress	спортивный костюм
dresseerija	дрессировщик
dresseerima	дрессировать
dresseerimine	дрессировка
Dubai	Дубай
Dublin	Дублин
duett	дуэт
dünastia	династия
duši all käima	принимать душ
dušiga	с душем
dušš	душ
Düsseldorf	Дюссельдорф
düüs	сопло
DVD	DVD-диск
DVD-mängija	проигрыватель DVD
džäss	джаз
džemm	джем, конфитюр
džungel	джунгли
džuudomaadleja	дзюдоист
eakas	немолодой
eakas	пожилой
eales	никогда
ebaharilik	необыкновенный
ebajumal	идол
ebajumal	кумир
ebameeldiv	неприятный
ebameeldivus	неприятность
ebamugavus	дискомфорт
ebaõiglane	несправедливый
ebaõiglus	несправедливость
ebaõnn	неудача (невезение)
ebaõnnestumine	невезение
ebaõnnestunud	неудачный (попытка)
ebaseaduslik	незаконный
ebausk	суеверие
ebausklik	суеверный
Ecuador	Эквадор
edasi	вперёд
edasi	вперёд (движение)
edasi lükkama	перенести (о сроке)
edu	успех
edukalt	успешно
edukas	успешный
eelajalooline	доисторический
eelarve	бюджет
eeldama	предполагать
eeldus	предположение
eelistama	предпочитать
eelmine kord	в прошлый раз
eemaldama	удалить
eemaldama	удалять (пятно и т.п.)
eemaldatud	удалённый (о файле)
ees	впереди
ees	перед (в пространстве)
eesel	ишак
eesel	осёл
eeskujulik	отличный (хороший)
eesliide	приставка
eesmärk	цель
eesmine	передний
eesnimi	ИМЯ
eesriie	занавес
eessõna	предлог
eest	спереди
eest ära tulema	оторваться (о пуговице)
eestkostja	опекун
eesveoga	переднеприводный
Eeva	Ева
efekt	эффект
Egeuse meri Aadria meri	Эгейское море Адриатическое море
egiptlane	египтянин
egiptlanna	египтянка
Egiptus	Египет
egiptuse	египетский
egoist	эгоист
egoistlik	эгоистичный
ehitaja	строитель
ehitama	строить
ehitus	стройка (место)
ehmatama	пугать
ehmuma	пугаться
ehtima	украшать
ehtima	украшать (дом и т.п.)
ei	не
ei	нет
ei kellegi oma	ничей
ei tohi	нельзя (запрещено)
eile	вчера
eile õhtul	накануне
eitama	отрицать
ekraan	экран
eksam	экзамен
eksamit sooritama	сдавать экзамены
eksemplar	экземпляр (документа)
eksima	ошибаться
ekskavaator	экскаватор
ekskursioon	экскурсия
ekskursioonijuht	экскурсовод
eksootika	экзотика
eksootiline	экзотический
ekspeditsioon	экспедиция
ekspluateerima	эксплуатировать
ekspluateerimine	эксплуатация
ekvaator	экватор
elajas	зверь
elama	жить (проживать)
elama	жить (существовать)
elamukvartal	жилой квартал
elanikkond	население
elanikud	жильцы
elavhõbe	ртуть
Elbrus	Эльбрус
elegantne	элегантный
elekter	свет (электричество)
elekter	электричество
elektri-	электрический
elektrienergia	электроэнергия
elektrijaam	электростанция
elektrik	электрик
elektripirn	лампочка
elektripirn	лампочка (индикатор)
elektripliit	плита электрическая
elektrirai	электрический скат
elektririist	электроприбор
elektritool	электрический стул
element	элемент
elevandipoeg	слонёнок
elevant	слон
ellu jääma	выжить
elu	ЖИЗНЬ
eluaegne vanglakaristus	пожизненное заключение
elukeskkond	среда обитания
elukindlustus	страхование жизни
elukoht	место жительства
elukutse	профессия
elulookirjeldus	резюме
elulugu	автобиография
ema	мама
ema	мать
emasloom	самка
emigrant	эмигрант
emigratsioon	эмиграция
emigreerima	эмигрировать
end ära põletama	обжечься
end torkama	уколоться
endale sisse lõikama	порезаться
energia	энергия
ennast	себя
ennast ära peitma	прятаться
ennast kaitsma	защищаться
ennast kaitsma	обороняться
ennast pesema	мыться
ennast ravima	лечиться
enne	перед (во времени)
ennistama	реставрировать
ennistamine	реставрация
ennustaja	гадалка
ennustama	гадать (о гадалке)
entsüklopeedia	энциклопедия
entusiasm	энтузиазм
entusiasmi üles näitama	проявить энтузиазм
entusiast	энтузиаст
epideemia	эпидемия
epilepsia	эпилепсия
episood	эпизод
epitsenter	эпицентр
era-	частный (личный)
erakond	партия
eraldi	отдельно
erand	исключение
eraomand	частная собственность
eravaldus	частные владения
erinev	различный (разный)
erinevus	различие
eriti	особенно
ese	объект (предмет)
esik	передняя
esik	прихожая
esile kerkima	возвышаться
esimees	председатель
esimene	первый
esimene koht	первое место
esimest korda	впервые
esindusrõdu	бельэтаж
esitama	предъявлять
esiteks	во-первых
esmaspäev	понедельник
et	что (союз)
etapp	этап (работы и т.п.)
etendus	представление
etendus	спектакль
ette heitma	упрекать
ette käima	спешить (о часах)
ette kandma	докладывать
ette nägema	предвидеть (ожидать)
ette ütlema	подсказать (отгадку)
ette valmistama	подготовить
ettekääne	отговорка
ettekandja	официантка
ettekuulutus	пророчество
etteotsa asuma	возглавлять
etteütlemine	подсказка (ключ к отгадке)
etteütlus	диктант
ettevaatlik	осторожный
Ettevaatust!	Осторожно!
ettevõte	предприятие
ettur	пешка
eukalüpt	эвкалипт
euro	евро
Euroopa	Европа
euroopa	европейский
Euroopa Liit	Европейский Союз
euroopa piison	зубр
eurooplane	европеец
evakuatsioon	эвакуация
evakueerima	эвакуировать
Evangeelium	Евангелие
Everest	Эверест
evolutsioon	эволюция
faasan	фазан
fail	файл
faks	факс
faksi saama	получать факс
faksi saatma	отправлять факс
fänn, poolehoidja	фан, болельщик
farm	ферма
fašism	фашизм
fašist	фашист
fassaad	фасад
feodaal	феодал
feodaalne	феодальный
filmi näitama	показывать фильм
filmi võtma	снимать фильм
filmilaenutus	прокат фильмов
filmitäht	кинозвезда
filmivõtted	съёмки
filosoof	философ
filosoofia	философия
filter	фильтр
filtreerima	фильтровать
finaal	финал (спорт.)
finaal-	финальный
finiš	финиш
Firenze	Флоренция
firma	фирма
firmamärk	фирменный знак
flamingo	фламинго
flööt	флейта
foneetika	фонетика
fookus	фокус
foon	фон
foorum	форум
forell	форель
foto	фото, фотография
fotoaparaat	фотоаппарат
fotoateljee	фотоателье
fotograaf	фотограф
fotokaamera	цифровой фотоаппарат
fotokorrespondent	фотокорреспондент
fragment	фрагмент
frakk	фрак
frank	франк
Frankfurt	Франкфурт
fresko	фреска
funktsioneerima	функционировать
furgoon	фургон
füüsik	физик
füüsika	физика
Gaana	Гана
gaas	газ
gaasijuhe	газопровод
gaasimask	противогаз
gaasipedaal	педаль газа
gaasipliit	плита газовая
gabariittuled	габаритные огни
galaktika	галактика
galerii	арт-галерея
gallid	галлы
galopp	галоп
galoppi sõitma	скакать галопом
Ganges	Ганг
gangreen	гангрена
gangster	гангстер
garaaž	автосервис
garaaž	гараж
gastriit	гастрит
gastroleerima	гастролировать
geen	ген
geiser	гейзер
generaator	генератор
Genf	Женева
geograafia	география
geoloog	геолог
geoloogia	геология
geomeetria	геометрия
gepard	гепард
geraanium	герань
gibon	гиббон
giid	гид (экскурсовод)
gladiool	гладиолус
glaukoom	глаукома
gloobus	глобус
golf	гольф
golfikepp	клюшка
golfiklubi	гольф-клуб
golfimängija	игрок в гольф
gong	ГОНГ
goodid	готы
gooti	готический
gorilla	горилла
graafika	графика
gramm	грамм
grammatika	грамматика
granaat	ручная граната
granaatõun	гранат
graniit	гранит
gravüür	гравюра
greip	грейпфрут
gripp	грипп
grupp	группа
grusiinlanna	грузинка
gruusia	грузинский
Haag	Гаага
hääl	голос
hääldama	произносить (слово)
hääldama	произносить(слово)
hääldamine	произношение
hääleõigus	право голоса
häälestused	настройки
hääletama	голосовать
hääletamine	голосование
haamer	молот
haamer	молоток
haarama	хватать (за руку и т.п.)
haarang	облава
haav	осина
haav	рана
haavama	ранить
haavand	язва (внутренняя)
haavapuravik	ПОДОСИНОВИК
haavata saama	получить ранение
haavatu	раненый (сущ.)
haavlid	дробь
habe	борода
habemeajamiskreem	пена для бритья
habet ajama	бриться
häbi	позор
häbi	стыд
habras	хрупкий
haige	больной
haige olema	болеть (быть больным)
haigeks jääma	заболеть
haiget saama	ушибиться
haiget saanud koht	ушиб
haiget tegema	причинять боль
haigla	больница
haigur	цапля
haigus	болезнь
haigushoog	приступ, припадок
haigutama	зевать
Haiiti	Гаити
haikala	акула
häire	тревога (сигнал)
häired	помехи
haisema	пахнуть
hajameelne	рассеянный
hajameelne skleroos	рассеянный склероз
hakk	галка
häkker	хакер
hakkliha	фарш
hakklihamasin	мясорубка
halb	плохой
halb hinne	плохая отметка
halb ilm	непогода
hall	седой (о волосах)
hall	серый
hall	холл
hall	холл (в театре)
halvama	парализовать
halvasti	ПЛОХО
halvatus	паралич
hambaarst	дантист
hambaid pesema	чистить зубы
hambaork	зубочистка
hambapasta	зубная паста
hambavalu	зубная боль
Hamburg	Гамбург
hamburger	гамбургер
hammas	зуб
hammast välja tõmbama	удалять (зуб)
hammustama	кусать (о собаке и т.п.)
hammustama	раскусить
hamster	хомяк
hang	сугроб
hani	гусь
Hanoi	Ханой
hantlid	гантели
hapnik	кислород
hapnikumask	кислородная маска
hapu	кислый
hapukoor	сметана
hapuoblikas	щавель
harakas	сорока
harf	арфа
härg	вол
hari	швабра
harilik	обычный
harjumus	привычка
harjutus	упражнение
härmatis	иней
harpuun	гарпун
haruldane	редкий
harva	редко
Hästi!	Хорошо! (согласен)
hauakivi	надгробие
hauatagune elu	загробная жизнь
haud	могила
haug	щука
haukuma	лаять
haukumine	лай
Havanna	Гавана
häving	разруха
hävitama	уничтожать (~ улики)
hävituslennuk	истребитель
hea	добрый
hea	хороший
hea hinne	хорошая отметка
Hea küll!	Ладно! (согласен)
Head isu!	Приятного аппетита!
headus	добро
heaks kiitma	одобрить
heakskiitmine	одобрение
healoomuline	доброкачественная
heeringas	сельдь
hein	сено
heitgaasitoru	выхлопная труба
hekk	изгородь
hektar	гектар
helde	щедрый
heldus	щедрость
hele	светлый
hele	светлый (о цвете)
helendama	светиться (блестеть)
helesinine	голубой
heli	звук
helikopter	вертолёт
helilooja	композитор
heliplaat	пластинка (муз.)
heliriba	звуковая дорожка
helisignaal	звуковой сигнал
helistama	звонить
helistama	позвонить
hell	нежный (о человеке)
helmed	бусы
Helsingi	Хельсинки
hepatiit	гепатит
heraldika	геральдика
heraldiline	геральдический
herilane	оса
hernes	горох
hertsog	герцог
hetk	МИГ
higi	пот
higistama	потеть
hiiglane	великан
hiilima	красться
Hiina	Китай
hiina	китайский
hiinlane	китаец
hiinlanna	китаянка
hiir	мышь
hiirepoeg	мышонок
hiirevaip	коврик для мыши
hilinema	задерживаться (о рейсе)
hilinema	опаздывать
hilja	поздно
hilja	поздно (~ встать)
hiljaks jääma	опоздать (на автобус)
hiljem	позже
hiljuti	недавно
Himaalaja	Гималаи
hind	цена
hindu	индиец
hinduism	Индуизм
hinduist	индуист
hindulanna	индианка
hing	душа
hing	дыхание
hingama	дышать
hingamine	дыхание
hinnakujundamine	ценообразование
hinnaline	ценный
hinnalipik	ценник (на одежде)
hinnapoliitika	ценовая политика
hinne	отметка
hinnet panema	ставить отметку
hipodroom	ипподром
hirm	страх
hirmus	страшный
hirmus	страшный (мороз и т.п.)
hirnuma	ржать
Hiroshima	Хиросима
hirss	просо
Hispaania	Испания
hispaania	испанский
hispaanlane	испанец
hispaanlanna	испанка
hõbe	серебро
hõbedane	серебристый
hõbedane	серебряный
hobi	хобби
hobujõud	лошадиная сила
hobune	конь
hobune	лошадь
hobune	лошадь, конь
hobusekari	табун
hobuseraud	подкова
hobusesaba	хвост (причёска)
hobusetall	конюшня
hobust rautama	подковать
hoiatama	предостеречь
hoiatama	предупреждать
hoiatus	п ред остережен ие
hoiatus	предупреждение
hoidma	держать
hõimud	племена
hõivatud	занятой (о человеке)
hoki	хоккей
hokikepp	клюшка
hokimängija	хоккеист
Holland	Голландия
hollandi	голландский
hollandlane	голландец
hollandlanna	голландка
homaar	омар
homme	завтра
homme hommikul	завтра утром
homme õhtul	завтра вечером
homme pärast lõunat	завтра после обеда
hommik	утро
hommikul	утром
hommikul vara	рано утром
hommikumantel	халат (махровый)
hommikumantel	халат(махровый)
hommikusöök	завтрак
hommikust sööma	завтракать
homoseksualist	гомосексуалист
Hongkong	Гонконг
hooaeg	сезон
hõõguv	раскалённый
hooletu	небрeжный
hooletu	небрежный
hoolitsema	ухаживать (за больным)
hoolitsema	ухаживать (за садом)
hoolitsev	заботливый
hoolitsus	забота (о человеке)
hoolitsus	уход (за больным)
hoone	здание
hoor	шлюха
hoorapoeg	сукин сын
höövel	рубанок
hööveldama	строгать
hoovi hm	ливень
hoovus	течение
horisontaalne	горизонтальный
horoskoop	гороскоп
hospital	госпиталь
hotell	гостиница
hüään	гиена
Huang He	Хуанхэ
hüatsint	гиацинт
hukkama	казнить
hukkamine	казнь
hukkuma	погибнуть
hulgi	ОПТОМ
hulgi-	оптовый
hulgimüük	продажа оптом
huligaan	хулиган
hüljes	тюлень
hulk	количество
hull	сумасшедший
hulluks minema	сойти с ума
hullumeelne	сумасшедший (прил.)
hundikari	стая (волков)
hundikutsikas	волчонок
hunt	волк
hüpnoos	ГИПНОЗ
hüpnotiseerima	гипнотизировать
hüpotees	гипотеза
hüppaja	прыгун
hüppama	прыгать
hüüdnimi	прозвище
hüüdsõna	междометие
huuled	губы
huumor	юмор
huumorimeel	чувство (юмора)
hüüumärk	восклицательный знак
hüvasti jätma	прощаться
huvi tundma	интересоваться
huvirühm	целевая аудитория
huvitav	интересный
I ill	цветок
ida	восток
ida-	восточный
idas	на востоке
ideaal	идеал
idioot	идиот
idu	росток
iga	каждый
iga aastane	ежегодный
iga kuu	каждый месяц
iga päev	ежедневно
iga viieteist minuti tagant	каждые 15 минут
iga-aastane	ежегодный
igakuine	ежемесячный
igal aastal	ежегодно
igal aastal	каждый год
igal nädalal	еженедельно
igal pool	везде
igal teisipäeval	каждый вторник
iganädalane	еженедельный
igapäevane	ежедневный
igas kuus	ежемесячно
igatsema	тосковать
igav	скучный
igavik	вечность
igavlema	скучать
ige	десна
igihaljas	вечнозеленое
iguaan	игуана
iha	влечение
ihukaitsja	телохранитель
iial, iialgi, eales	никогда
iidne	древний
iidol	идол
iiri	ирландский
Iirimaa	Ирландия
iirlane	ирландец
iirlanna	ирландка
Iisrael	Израиль
iisraeli	израильский
iisraellane	израильтянин
iisraellanna	израильтянка
ikoon	икона
illuminaator	иллюминатор
illustratsioon	иллюстрация
ilm	погода
ilma	без (~ сахара и т.п.)
ilma aktsendita	без акцента
ilma jätma	лишать
ilmaennustus	прогноз погоды
ilmuma	выйти (о книге)
ilmumine	выход (книги)
ilukirjandus	беллетристика
ilus	красивая
ilus	красивый
iluuisutaja	фигурист
iluuisutaja	фигуристка
iluuisutamine	фигурное катание
ilves	рысь
imago	имидж
ime	чудо
imeilus	прекрасный (красивый)
imema	сосать
imestama	удивляться
imestus	удивление
imik	младенец
immuniteet	иммунитет
impeerium	империя
imperaator	император
impressaario	импресарио
impressionism	импрессионизм
indeks	индекс
india	индийский
India	Индия
India ookean	Индийский океан
indiaanlane	индеец
indikaator	индикатор
Indoneesia	Индонезия
infarkt	инфаркт
inflatsioon	инфляция
ingel	ангел
ingellik	ангельский
inglane	англичанин
inglanna	англичанка
inglise	английский
Inglismaa	Англия
ingver	имбирь
ingver	инжир
inimene	человек
inimesed	люди
inimkond	человечество
inimrööv	похищение (людей)
inimsooja	людоед
inkvisiitor	инквизитор
inkvisitsioon	инквизиция
innustama	воодушевлять
insener	инженер
inspektor	инспектор
instituut	институт
instruktsioon	инструкция по безопасности
insult	инсульт
internet	интернет
invaliid	инвалид
invaliidikäru	инвалидная коляска
investeerima	инвестировать
investeeringud	инвестиции
Iraak	Ирак
Iraan	Иран
isa	отец
isa (paps)	папа
isane	самец
isasloom	самец
ise	сам
iseloom	характер
iseloomujooned	черты характера
iseravimine	лечение
isiklik	персональный
isiklik arst	личный врач
islam	Ислам
Island	Исландия
island lanna	исландка
islandi	исландский
islandlane	исландец
Issand	Г осподь
Istanbul	Стамбул
istandus	плантация
iste	сиденье
istuma	садиться
istuma	сесть
istuma	сидеть
Itaalia	Италия
itaalia	итальянский
itaallane	итальянец
itaallanna	итальянка
itta	на восток
ja	и
ja (jaatus)	да
ja (sidesõna)	и
jaa	да
jaa	лёд
jää	лёд
jaaaeg	ледниковый период
jääauk	прорубь
jaaguar	ягуар
jäähokit mängima	играть в хоккей
jääkapp	морозильник
jääkaru	белый медведь
jäälõhkuja	ледокол
jaam	станция
jääma	оставаться
jaanalind	страус
jaaniuss	светлячок
jaanuar	январь
Jaapan	Япония
jaapani	японский
jääpank	льдина
jaapanlane	японец
jaapanlanna	японка
Jäär	Овен
jäärak	овраг
jäätis	мороженое
jae	розничный
jaemüük	продажа в розницу
jagama	делить (матем.)
jagu	ВЗВОД
jahe	прохладный
jahikoer	охотничья собака
jahil käima	охотиться
jahimees	ОХОТНИК
jaht	яхта
jahtuma	охлаждаться
jahu	мука
jahutama	охладить
jahutusvedelik	охлаждающая жидкость
jakk	жакет
jakk	кофта (шерстяная)
jalaga lööma	лягнуть
jalakäija	пешеход
jalakäijate tsoon	пешеходная зона
jalakäijate tunnel	подземный переход
jalakäijate ülekäik	пешеходный переход
jalakas	вяз
jalalaba	ступня
jalam	подножие (горы)
jalatsid	обувь
jalg	лапа (птицы)
jalg	нога
jalg	ножка (стола, стула)
jalg	фут
jälg	след
jälg	след (отпечаток ноги)
jälgima	наблюдать
jälgima	следить (выслеживать)
jalgpall	футбол
jalgpalli mängima	играть в футбол
jalgpalliklubi	футбольный клуб
jalgpallur	футболист
jalgrada	тропинка
jalgratas	велосипед
jalgrattaga sõitma	ехать на велосипеде
jalgrattasport	велоспорт
jalgrattur	велосипедист
jalgsi	пешком
jälitama	преследовать
jälle	опять
jalus	стремя
jalutama	гулять (прогуливаться)
jalutuskäik	прогулка (пешком)
jalutuskepp	трость
jama, mõttetus	ерунда
Jamaika	Ямайка
jänes	заяц
jänesepoeg	зайчонок
Jangtse	Янцзы
jaoks	для (предлог)
jard	ярд
järele jõudma	обогнать
järelepärimine	запрос
järelkäru	прицеп
järelliide	суффикс
järelvaataja	охранник (в тюрьме)
järglased	ПОТОМСТВО
järgmine	следующий
järgmine kord	в следующий раз
järgmine peatus	следующая остановка
järgmiseks päevaks	на следующий день
järgmisel aastal	в следующем году
järgmisel nädalal	на следующей неделе
järgmises kuus	в следующем месяце
järgnema	следовать за ...
järjehoidja	закладка
järjekord	очередь (в первую ~)
järsk kurv	крутой поворот
järsk lang	крутой спуск
järv	озеро
jasmiin	жасмин
jässakas	коренастый
jätkama	продолжать
jeen	йена
Jeesus	Иисус
Jeesus Kristus	Иисус Христос
Jeruusalemm	Иерусалим
jõehobu	бегемот
jõgi	река
jogurt	йогурт
jõhker	грубый
jõhvikas	клюква
jood	йод
jooga	йога
joogi-	питьевая
joogivesi	питьевая вода
jooks	бег
jooks uaed	вольер
jooksja	бегун
jooksma	бегать
jooksma	бежать
jooksurada	беговая дорожка
jooma	пить
joon	линия
joon	черта
joonestama	чертить
joonis	чертёж
joonistama	рисовать
joonistama	рисовать (карандашом)
joonistama	рисовать (красками)
joonistus	рисунок
joonlaud	линейка
jootekolb	паяльник
jootma	паять
jootma	поить
jope	куртка (кожаная и т.п.)
Jordaania	Иордания
jõud	сила
jõud	сила (мощь)
jõud	сила (человека)
jõudma	достигать (напр. - полюса)
jõulud	рождество
Jõuluvana	Санта Клаус
jõupingutus	усилие
juba	уже
judaism	Иудаизм
judo	дзюдо
juga	водопад
juhataja	руководитель, шеф
juhataja	управляющий
juhe	провод
juhiload	водительские права
juhiload	права водительские
juht	глава (~ делегации)
juht	менеджер
juhtima	вести (автомобиль)
juhtima	руководить (чем-л.)
juhtimine	управление (процесс)
juhtkond	начальство
juhtlause	девиз
juhtmed	проводка
juhtmestik	проводка
juhtum	происшествие
juhtuma	случиться
juhuslikult	случайно
julge	смелый
julgus	смелость
julm	жестокий
jumal	бог
Jumalaema	Богородица
jumalanna	богиня
jumalat uskuma	верить (в бога)
jumalateenistus	служба (рел.)
junga	юнга
Jupiter	Юпитер
juriidiline	юридический
juriidiline aadress	юридический адрес
jurist	юрист
jutlus	проповедь
jutlustaja	проповедник
jutt	разговор
jutt	рассказ
jutumärgid	кавычки
jutumärkides	в кавычках
jutustama	рассказывать
jutustus	повесть
juua tahtma	хотеть пить
juudalane	иудей
juudi	еврейский
juuditar	еврейка
juuksed	волосы
juuksehari	щётка для волос
juukseklamber	заколка
juukselõikus	стрижка (причёска)
juuksenõel	шпилька
juuksur	парикмахер
juuksurisalong	парикмахерская
juuli	июль
juuni	июнь
juur	корень
juurdepääs	доступ
juurdepääsmatu	неприступный
juures	у ... (около)
juurima	корчевать
juurviljad	ОВОЩИ
juurviljapood	овощная лавка
juus(ksed)	волос
juust	сыр
juut	еврей
ka	тоже
kaabel	кабель
kaabu	шляпа
kaadriagentuur	кадровое агентство
kaagutama	кудахтать
kaal	вес
Kaalud	Весы
kaaluma	взвешивать
kaalus alla võtma	худеть (быть на диете)
kaaluta olek	невесомость
kaamel	верблюд
kaamelipoeg	верблюжонок
kaan	пиявка
käänamine	склонение
kääne	падеж
kaardi pakk	колода
kaardid	карты
käärid	ножницы
kaaries	кариес
kaart	карта
kaart	карта (географ.)
kaart	карта игральная
kaarte segama	тасовать
kaarte välja jagama	сдавать (карты)
kaarti saama	получить открытку
kaarti saatma	отправить открытку
kaas	крышка (чайника и т.п.)
kaas	обложка (книги)
kaasa arvatud	включая
kaasasündinud	врождённый
kaashäälik	согласный звук
kaasosaline	сообщник
kaater	катер
kabatšokk	кабачок
kabe	шашки
kabehirv	лань
kabel	часовня
kabi	копыто
käbi	шишка (сосновая)
kabiin	кабина
kabiin	кабина (лифта)
kabinet	кабинет
kabinet	кабинет (на работе)
kabriolett	кабриолет
kadakas	можжевельник
kadestama	завидовать
kadumine	исчезновение
kadunu	покойник
kadunuks jääma	исчезнуть
kaebama	жаловаться
kaebus	жалоба
käekell	часы (наручные)
käekott	сумочка (женская)
kael	шея
käelaba	КИСТЬ
kaelakee	ожерелье
kaelarihm	ошейник
kaelkirjak	жираф
kaer	овёс
käerauad	наручники
käetugi	ПОДЛОКОТНИК
kaev	колодец
kaevama	копать
kaevama	копать (~ котлован)
kaevama	копать (вскапывать)
kaevama	рыть
kaevama	рыть, копать
kaevandama	добывать (руду)
kaevandamine	добыча
kaevandus	рудник, шахта
käevõru	браслет (украшение)
kaevur	шахтёр
kägu	кукушка
kahe aasta pärast	через 2 года
kahe kuu pärast	через 2 месяца
kaheinimesetuba	двухместный номер
kahekordistama	удваивать
kaheksa	восемь
kaheksajalg	осьминог
kaheksakümmend	восемьдесят
kaheksas	восьмой
kaheksateist	восемнадцать
kahekümne minuti pärast	через 20 минут
kahetsema	сожалеть
kahetsus	сожаление
kahevõitlus	поединок
Kahju!	Жаль!
kahtlane	подозрительный
kahtlema	сомневаться
kahtlustama	подозревать
kahtlustus	подозрение
kahur	пушка (на танке)
kahurivägi	артиллерия
kahvatu	бледный
kahvel	вилка
käigukang	рычаг коробки передач
käigukast	коробка передач
käik	ХОД
käik	ход (в игре)
käiku laskma	запускать (начинать)
käima	ходить
Kairo	Каир
kaitse	оборона, защита
kaitse	предохранитель
kaitseraud	бампер
kaitsevägi	армия
kaitsevall	заграждение
kaitsma	защищать (страну)
kaitsma	оборонять, защищать
käitumine	поведение
käive	оборот
käiviti	стартер
kaja	эхо
kajakas	чайка
kajut	каюта
kakk	филин
kaklema	драться (в драке)
kaklus	драка
kaks	два
kaks korda kuus	2 раза в месяц
kaks korda nädalas	2 раза в неделю
kaks päeva tagasi	2 дня назад
kaksikud	близнецы
kakskümmend	двадцать
kakssada	двести
kaksteist	двенадцать
kaktus	кактус
kala	рыба
kala püüdma	ловить рыбу
Kalad	Рыбы
kalamari	икра
kalamees	рыбак
kalaparv	стая (рыб)
kalapüük	рыбалка
kalasaak	улов
kaldapealne	набережная
kaldast eemalduma	отчаливать
kalender	календарь
kaliiber	калибр
kalju	скала
kaljujoonis	наскальный рисунок
Kaljukits	Козерог
kaljulõhe	расщелина
kaljuronija	скалолаз
kalkulaator	калькулятор
kalkun	индейка
kalkun	индюк
kalkun	индюшка
Kalkuta	Калькутта
kallale tungima	нападать
kallaletung	нашествие
kallas	берег
kallim	любимый (человек)
kallinema	подорожать
kallis	дорогой
kallis (hinnaline)	ценный
kalmaar	кальмар
kalmistu	кладбище
kalor	калория
Kambodža	Камбоджа
kameeleon	хамелеон
kamin	камин
kamm	расчёска
kammitsema	стреножить
kampaania	кампания (напр. рекламная)
kampaania	кампания (промоушн ~)
kana	курица
kanaarilind	канарейка
Kanada	Канада
kanada	канадский
kanadalane	канадец
kanadalanna	канадка
kanal	канал
kanala	курятник
kanapoeg	цыплёнок
kand	пятка
känd	пень
kandidaat	кандидат
kandideerima	баллотироваться
kandik	поднос
kandiline	квадратный
kandma	носить (усы, бороду)
kaneel	корица
kanep	конопля
kang	лом
kang	штанга
kangas	ткань
kangekaelne	упрямый
kangelane	герой
kangelanna	героиня
kangelastegu	ПОДВИГ
känguru	кенгуру
kanister	канистра
kanjon	каньон
kann	кувшин
kannatama	испытывать
kannatama	страдать
kannatamatu	нетерпеливый
kannatlik	терпеливый
kannikas (tuhar)	ягодица
kannike	фиалка
kantseleikaubad	канцтовары
kaotama	потерять
kaotama	проиграть
kaotama	проиграть (в спорте)
kaotama	терять
kaotus	поражение
kaotus	поражение (проигрыш)
kaotus	проигрыш
kapital	капитал
kapitalism	капитализм
kapitalistlik	капиталистический
kapott	капот
kapp	тумбочка
käpp	лапа (напр. собаки)
kapsas	капуста
kapten	капитан
kaptenisild	капитанский мостик
kapuuts	капюшон
karahvin	графин
karate	карате
karatist	каратист
kärbes	муха
kärbseseen	мухомор
karburaator	карбюратор
kardinal	кардинал
kardioloog	кардиолог
kargud	костыли
kari	стадо
karikakar	ромашка
karikas	кубок
karikatuur	карикатура
kariloomad	скот
karistama	наказать
karistama	наказывать
karistama	штрафовать (спорт)
karistus	наказание
karistusmeetmed	штрафные санкции
karjäär	карьера
karjääri tegema	продвигаться (о работе)
karjamaa	пастбище
karjamaal olema	пастись
karjatama	пасти (скот)
karje	крик
karjuma	кричать
karjuma hakkama	закричать
karjus	пастух
kärnkonn	жаба
karp	коробка
kärp	горностай
Karpaadid	Карпаты
karpkala	карп
kartlik	робкий
kartlikkus	робость
kartma	бояться
kartmatu	бесстрашный
kartul	картофель
kartulipüree	картофельное пюре
karu	медведь
käru	тележка для клюшек
karukoobas	берлога
karupoeg	медвежонок
karus nahkne	меховой
karusmari	крыжовник
karusnahk	мех
karvad	шерсть (животного)
Kas tõesti?	Неужели?
kasahh	казах
kasahhi	казахский
kasahhitar	казашка
Kasahstan	Казахстан
kasepuravik	подберёзовик
käsi	рука
käsi	рука (вся)
käsi raudu panema	надеть наручники
kasiino	казино
käsikiri	рукопись
käsipakid	ручная кладь
käsipuu	перила
käsipuu	поручень
käsitsi	вручную
kask	берёза
käsk	заповедь
käsk	команда (приказ)
käsk	приказ
kaskadöör	каскадёр
käskima	приказать
käskima	приказывать
käskjalg	курьер
kass	кот
kass	кошка
kassa	касса (в магазине)
kassatšekk	чек (кассовый)
kassett	кассета
kassiir	кассир
kassipoeg	котёнок
kast	ящик
kastan	каштан
kaste	соус
kastekann	лейка
kastma	поливать
kastmine	полив
kasu	выгода
kasu	польза
kasu	польза (полезность)
kasukas	шуба
kasulik	ВЫГОДНЫЙ
kasum	прибыль
kasumiga	прибыльный
kasutatud	бывший в употреблении
kasutatud	подержанный
kasv	рост
kasv	рост (процесс)
kasvaja	опухоль (внутренняя)
kasvama	расти
kasvandus	питомник
kasvatama	растить(растения)
kasvatus	воспитание
kasvuhoone	оранжерея
kasvuhoone	парник
katafalk	катафалк
kataloog	каталог
kataloog	папка (комп.)
katarakt	катаракта
katastroof	катастрофа
katastroof	катастрофа (перен.)
katedraal	собор
kategooria	категория
käterätik	полотенце
katk	чума
katke	обрыв (провода)
katkematu	непрерывный
katkend	отрывок
katkestama	прекращать
katkestama	прекращать (отношения)
katki minema	порвать (испортить)
katki minema	разорваться (о верёвке)
katoliiklane	католик
katoliiklik	католический
katoliiklus	Католицизм
katse	контроль (испытания)
katse	опыт (химический ~)
katse	попытка
kätte maksma	мстить
kätte maksma	отплатить (отомстить)
kätte saama	получить
kättemaks	месть
kattematerjal	обивка
katus	крыша
kaua	долго
kauakestev	продолжительный
kaubamärk	торговая марка
kaubanduskeskus	торговый центр
kaubandusnäitus	торговая выставка
kaubareisija	коммерсант
kauboi	ковбой
kauge	далёкий
kauge	дальний
kauge	дальний (отдалённый)
kaugekõne	междугородний
kaugel	далеко
kaugelt sugulane	дальний родственник
kaugenägelik	дальнозоркий
Kaug-lda	Дальний Восток
kaugtuled	дальний свет
kaugushüpe	прыжки в длину
Kaukasus	Кавказ
kaunid kunstid	изящные искусства
kaup	товар
kauplema	торговать
kauplus	магазин
kaval	хитрый
kavalus	хитрость
kavatsema	намереваться
kavatsus	намерение
keedetud	варёный
keedetud	кипячёный
keegi	кто-нибудь
keegi	кто-то
keel	струна
keel	язык
keel	язык (напр. русский)
keel (elund)	язык
keel (suhtlus)	язык
keelama	запретить
keelama	запрещать
keelatud	запрещённый
keelduma	отказываться
keeldumine	отказ
keema	кипеть
keemia	ХИМИЯ
keemiarelv	химическое оружие
keemik	химик
keemiline puhastus	химчистка
Keenia	Кения
keerlema	вращаться
keerlema	кружить (о птице)
keeruline	сложный
keeruline	сложный (вопрос и т.п.)
keetma	варить (готовить)
keetma	кипятить
keevitaja	сварщик
keha	тело
kelder	погреб
kell	звонок
kella kaheteistkümneks	к 12-ти часам
kella lööma	звонить (о колоколах)
kellanupp	кнопка (звонка)
kellarihm	браслет (на часах)
kellarihm	ремешок
kellassepp	часовщик
kellatorn	колокольня
Kelle?	Чей?
Kellega?	С кем?
kellegi oma	чей-нибудь
Kellele?	Кому?
Kellest?	О ком?
kellukas	колокольчик
kelner	официант
kepp	палочка (дирижёрская)
kera	шар (геометр.)
keraamika	керамика
keraamiline	керамический
kerge	лёгкий (о грузе)
kerge (kaalult)	лёгкий
kerge (mitte keeruline)	нетрудный
kergejõustik	лёгкая атлетика
kergekaal	легкий вес
kergelt haavama	повредить (поранить)
kergetööstus	лёгкая промышленность
kerjus	нищий (бродяга)
kerjuslik	нищий
kes	кто
Kes?	Кто?
kesk-	центральный
keskaegne	средневековый
keskel	посередине
keskel	среди
keskkaal	средний вес
keskkoht	середина
kesklinn	центр города
kesköö	полночь
keskpäev	полдень
keskpunkt	центр
ketser	еретик
ketserlus	ересь
ketsid	кеды
kett	цепь
kevad	весна
kevadel	весной
kevadine	весенний
khaan	хан
kibe	горький
kibuvits	шиповник
kihulane	мошка
kihv	клык
kii	кий
Kiiev	Киев
kiik	качели
kiil	стрекоза
kiilas	ЛЫСЫЙ
kiilasjää	гололёд
kiilaspea	лысина
kiin	овод
kiirabi	скорая помощь
kiire	быстрый
kiire	срочный
kiiresti	быстро
kiiresti	срочно
kiirtee	автомагистраль
kiirus	быстрота
kiirus	скорость
kiirust ületama	превысить скорость
kiirustama	торопить
kiirustama	торопить (кого-л.)
kiirustama	торопиться
kiitlema	хвастаться
kiitma	похвалить
kiitus	похвала
kiiver	каска
kiiver	шлем
kiivi	киви
kikerikii	кукареку
kikilips	галстук-бабочка
kild	осколок
kilekott	пакет (мешок)
Kilimandžaaro	Килиманджаро
kilogramm	килограмм
kilomeeter	километр
kilp	колпак (на колесе)
kilp	ЩИТ
kilpkonn	черепаха
kindad	перчатки
kindalaegas	отделение для перчаток
kindlus	крепость
kindlusemüür	стена (крепостная)
kindlustama	страховать
kindlustama	укреплять (положение)
kindlustus	страховка
kindral	генерал
kingad	туфли
kingakreem	крем для обуви
kingalusikas	рожок (для обуви)
kingapael	шнурок
kingapaelu siduma	шнуровать (ботинки)
kingapood	обувной магазин
kingitus	подарок
kingsepp	сапожник
kinni jääma	застрять
kinni keerama	закручивать
kinni külmuma	замёрзнуть
kinni olema	быть закрытым
kinni panema	закрывать
kinni pidama	задержать
kinni suruma	зажимать
kinni võtma	поймать (преступника)
kinnine	закрытый
kinnis	застёжка
kinnitama	подтвердить
kinnitama	утверждать (настаивать)
kinnitus	подтверждение
kinnivõtmine	поимка
kino	кино (вид искусства)
kino	кино, фильм
kino	кинотеатр
kinokaamera	кинокамера
kips	гипс
kipsist	из гипса
kirema	кукарекать
kirgiis	киргиз
kirgiis itar	киргизка
kirgiisi	киргизский
kiri	письмо
kiri	шрифт
kirik	церковь
kirik	Церковь (организация)
kirikukell	КОЛОКОЛ
kirja panema	записаться (на курсы)
kirjaklamber	скрепка
kirjalik hoiatus	предупреждающая надпись
kirjand	сочинение
kirjandus	литература
kirjanik	писатель
kirjastaja	издатель
kirjastus	издательство
kirjavahetus	переписка
kirjavahetuses olema	переписываться
kirjeldama	описать(обрисовать)
kirjeldus	описание
kirjutama	написать (книгу)
kirjutama	писать
kirjutama	писать (письмо и т.п.)
kirjutusmasin	машинка (пишущая)
kirp	блоха
kirsipunane	вишнёвый
kirsipuu	вишня
kirss	вишня
kirst	гроб
kirurg	хирург
kirves	топор
kiskja	ХИЩНИК
kitarr	гитара
kitarrist	гитарист
kits	коза
kitsas	узкий
kitsetall	козлёнок
kitsi	скупой
kittel	халат (врача)
kivi	камень
kiviaeg	Каменный Век
kivikirves	каменный топор
kivipuravik	белый гриб
kivist	каменный
klaas	стакан
klaas	стекло
klaas-	стеклянный
klaas itõstja	стеклоподъёмник
klaasipuhasti	щетки стеклоочистителя
klade	блокнот
klahv	клавиша
klapp	клапан
klapplaud	откидной столик
klarnet	кларнет
klass	класс
klassikaaslane	одноклассник
klaver	пианино
klaviatuur	клавиатура
kleepima	приклеивать
kleeplint	лента-скотч
kleit	платье
klemm	клемма
kloun	клоун
koaala	коала
kõbla	тяпка
kobra	кобра
kobras	бобр
kod ustama	приручать (животных)
koda	ракушка
kodakondsus	гражданство
kodanik	гражданин
kodu-	родной (о стране)
kodukino	домашний кинотеатр
kodukolle	домашний очаг
kodulinnud	домашняя птица
koduloomad	домашние животные
kodumaa	родина
kodune ülesanne	домашнее задание
kodusõda	гражданская война
kodustatud	ручной (о животных)
koer	собака
koer	собака, пёс
kogemus	опыт (знания)
kogenematu	неопытный
kogu aasta	весь год
koguduse liikmed	прихожане
koguma	коллекционировать
köha	кашель
kohakala	судак
kohal	над (наверху)
kohal olema	присутствовать
kohale sõitma	приехать
kohalik kõne	местный (звонок)
kohanema	приспосабливаться
kohe	немедленно
kõhetu	тощий
köhima	кашлять
kõhklev	нерешительный
kõhn	худой
koht	место
kõht	живот
kohta	о (говорить о ...)
kohtamine	свидание
kohtualune	подсудимый
kohtuasi	дело (уголовное)
kohtuma	встретиться
kohtuma	встречаться
kohtumine	встреча
kohtumõistmine	правосудие
kohtunik	судья
kohtuotsus	приговор
kohtupink	скамья подсудимых
kõhukinnisus	запор
kõhulahtisti	слабительное
kõhulahtisus	диарея
kõhulahtisus	расстройство желудка
kohus	суд (место)
kohustus	обязанность
kohustus	обязательство
kohustuslik	обязательный
kohustuste ring	круг обязанностей
kohut mõistma	судить (о судьях)
kohver	чемодан
kohvik	кофейня
kohvikann	кофейник
kohvikeetja	кофеварка
kohvituba	кофейня
kohviveski	кофемолка
koi	моль
köide	переплёт
köide	том
köide	том (издания)
kõige tähtsam	самый важный
Kõigevägevam	Всемогущий
kõik	все (все люди)
koiott	койот
köis	канат
koit	рассвет
kokk	кок
kokk	повар
kokkerspanjel	кокер-спаниель
kokku kukkuma	рухнуть
kokku langema	обвалиться
kokku varisema	обрушиться
kokkulangevus	совпадение
kokkulepe	соглашение
kokkuvõte	вывод (заключение)
kokkuvõtet tegema	делать заключение
kokutama	заикаться
kolb	поршень
kõlblik	пригодный
kole	страшный (рассказ)
koletis	чудовище
koletsüstiit	холецистит
kollane	жёлтый
Kollane meri	Желтое море
kollatõbi	желтуха
kolleeg	коллега
kollektsionäär	коллекционер
kollektsioon	коллекция
kolm	три
kolm tärni	3 звезды
kolmandaks	в-третьих
kolmapäev	среда
kolmas	третий
kolmas koht	третье место
kolmkümmend	тридцать
kolmnurk	треугольник
kolmnurkne	треугольный
kolmpunkt	многоточие
kolmteist	тринадцать
kolmveerand	без четверти
kolonel	полковник
koloonia	колония
kolumbia	колумбийский
Kolumbia	Колумбия
kolumbialane	колумбиец
kolumbialanna	колумбийка
koma	запятая
komandör	командир
kombain	комбайн
kombetalitus	ритуал
kombinatsioon	комбинация
kombinesoon	комбинезон
komeet	комета
komisjon	комиссия
komitee	комитет
komm	конфета
komme	обычай
kommentaator	комментатор
kommenteerima	комментировать
kommunism	коммунизм
kommunist	коммунист
kommunistlik	коммунистический
komöödiafilm	кинокомедия
kompanii	компания
kompass	компас
kompensatsioon	компенсация
kompliment	комплимент
kompressor	компрессор
kondenspiim	сгущённое молоко
kondiitripood	кондитерская
kondiitritooted	кондитерские изделия
konditsioneer	кондиционер
kondor	кондор
kõne	речь (выступление)
kõnekäänd	поговорка
kõnelema, rääkima	говорить
konfiskeerima	конфисковать
konflikt	конфликт
Kongo	Конго
kongress	конгресс
koni	окурок
konkureerima	конкурировать
konkurent	конкурент
konkurents	конкуренция
konkurss	конкурс
konn	лягушка
konnapoeg	лягушонок
kõnnitee	тротуар
konservaator	консерватор
konservatiivne	консервативный
konserviavaja	открывалка (для консервов)
konservid	консервы
konspiratsioon	конспирация
konstitutsioon	конституция
konsul	консул
konsultant	консультант
kontakt	контакт
konteiner	контейнер
kontor	офис
kontrabass	контрабас
kontraht	контракт
kontrahti rikkuma	нарушить контракт
kontrollima	контролировать
kontrollima	проверить
kontrollima	проверять
kontrollimine	проверка
kontrollpakk	контрольный пакет
kontrolltöö	контрольная работа
kontrolör	контролёр
konts	каблук
kontsert	концерт
kontuur	контур
konverents	конференция
konverentsisaal	конференц-зал
konvoi	конвой
koobas	пещера
kood	КОД
koodlukk	кодовый замок
kook	пирожное
köök	кухня
köök	кухня (помещение)
köök	кухня(национальная)
kookospähkel	орех кокосовый
kool	школа
koolera	холера
kooli minema	идти в школу
koolibri	колибри
koolidirektor	директор школы
kooliõpilane	ШКОЛЬНИК
koolipink	парта
koolis käima	учиться (ходить в школу)
koolitüdruk	школьница
koolivaheaeg	каникулы
koolivaheajal olema	быть на каникулах
koolon	двоеточие
kooma	кома
koomas olema	быть в коме
köömned	тмин
koon	пасть
koonduslaager	концлагерь
koopaorav	сурок
koopiamasin	копировальный аппарат
koopiat tegema	делать копию
koor	кожура
koor	кора
koor	сливки
koor	хор
kõõrdsilmne	косоглазый
kõõrdsilmsus	косоглазие
koorima	чистить (картошку и т.п.)
koos	вместе
koos	с ... (с кем-л.)
koosolek	собрание
koosseis	кадры, штат
koostama	составлять (~ список)
koostööd tegema	сотрудничать
kootud müts	вязаная шапочка
kopeerima	скопировать
Kopenhaagen	Копенгаген
kopp	ковш
kopsupõletik	воспаление лёгких
koputa	стучи
koputama	стучать
koputama	стучать (в дверь)
koputus	стук
koputus	стук (в дверь)
koputus	стук (шум)
Koraan	Коран
korall	коралл
korallrahu	коралловый риф
kõrb	пустыня
kord	порядок (в комнате)
korda ajama	улаживать
korda ajama	урегулировать (конфликт)
korda tegema	приводить в порядок
korda tegema	убирать (~ квартиру)
korda tegema	убирать (наводить порядок)
kordama	повторять
korea	корейский
korealane	кореец
korealanna	кореянка
kõrge	высокий
kõrge	глубокий
kõrge palavik	высокая температура
kõrgem	высший
korgitser	штопор
kõrgliiga	высшая лига
Kõrgõzstan	Кыргызстан
kõrgus	высота
kõri	горло
koriander	кориандр
koristaja	уборщица
koristama	убирать (урожай)
korjama ära eksima	собирать (грибы, ягоды) заблудиться
kork	Пробка (электр.)
korporatsioon	корпорация
korralagedus	беспорядок
korraldama	организовывать
korraldama	устраивать (~ вечеринку)
korraldamine	организация (процесс)
korralik	аккуратный (работа и т.п.)
korrespondent	корреспондент
korruptsioon	коррупция
korrutama	умножать (матем.)
kõrs	колос
korter	квартира
kortsu minema	помяться (об одежде)
korv	корзина
kõrv	ухо
kõrvaklapid	наушники
kõrval	около (рядом)
kõrvaldama	устранять (препятствие)
kõrvalmaitse	привкус
kõrvalt	сбоку (со стороны)
kõrvarõngad	серьги
kõrvits	тыква
korvpall	баскетбол
korvpallur	баскетболист
kosmeetika	косметика
kosmiline	космический
kosmos	КОСМОС
kosmoselaev	космический корабль
kostitama	угощать
kotik	котик
kotkas	орёл
kotkas	СОКОЛ
kotlett	котлета
kott	мешок (сахара и т.п.)
kott	сумка
kõu	гром
kõva	твёрдый
kõva	твёрдый (не мягкий)
kõvaketas	жёсткий диск
kõvaketta mälumaht	объём жесткого диска
kõver	кривая (сущ.)
kõver	кривой
kraad	градус
kraadiklaas	градусник
kraadiklaas	термометр
kraaksuma	каркать
kraan	кран
kraana	строительный кран
kraanikauss	раковина
kraater	кратер
kraav	канава
kraav	кювет
krabi	краб
krae	воротник
krahv	граф
krambid	судороги
krediidikaart	кредитная карта
krediiti võtma	в кредит
Kreeka	Г реция
kreeka	греческий
kreeka pähkel	орех (грецкий)
kreeklane	грек
kreeklanna	гречанка
kreem	крем
kreemjas	кремовый
krematoorium	крематорий
kress	настурция
krevett	креветка
kriimustama	царапать
kriimustus	царапина
kriis	кризис
kriit	мел
kriitik	критик
kriitika	критика
kriminaalfilm	детектив
kriminaalne	криминальный
kriminull	детектив
kristall	кристалл
kristlane	христианин
kristlik	христианский
kristlus	Христианство
kritiseerima	критиковать
kriuks	скрип
kriuksuma	скрипеть
krohv	штукатурка
krohvima	штукатурить
krokodill	крокодил
krooks uma	квакать
kroon	корона
kruiis	круиз
krupjee	крупье
kruus	гравий
kruus	кружка
kruvi	винт
kruvi	шуруп
kruvikeeraja	отвёртка
Kuala Lumpur	Куала-Лумпур
kübar	котелок (шляпа)
kübar	шляпка (женская)
kuberner	губернатор
kuhu	куда
Kuhu?	Куда?
kuhugi	куда-то
Kui palju?	СКОЛЬКО? (неисчисл.)
Kui palju?	Сколько? (о цене)
kuid	но
kuidas	как
Kuidas?	Как?
kuiv	сухой
kuivatama	сушить
kuivatatud	сушёный
kukal	затылок
kukerpuu	барбарис
kukeseen	лисичка
kukk	петух
kukkuma	падать
kukutama	свергнуть
kukutamine	свержение
küla	деревня
külalisetendus	гастроли
külalistuba	гостиная
külastaja	посетитель
külastama	посещать
kuld	золото
kuldne	золотой
kuldnokk	скворец
kuldpulm	золотая свадьба
külg	бок
külg	сторона
külgkardinad	шторы
kulissid	кулисы
küljeklaas	боковое стекло
kull	ястреб
kulm	бровь
külm	холод
külm	холодный
külm vesi	холодная вода
külmalt	холодно
külmetuma	простудиться
külmetus	простуда
külmkapp	холодильник
külmrelv	холодное оружие
külmuma	замёрзнуть (о реке)
külmutatud	замороженный
külmutatud	замороженный (продукт)
külv	посев (действие)
külvama	сеять
külvik	сеялка
kumb	который
kumm	резина
kummardama	поклоняться
kummi-	резиновый
kumminui	резиновая дубинка
kummipuu	фикус
kummitus	привидение
kummut	комод
kümnes	десятый
kündma	пахать
küngas	холм
kuninganna	королева
kuningas	король
kuninglik	королевский
kuningriik	королевство
künnimaa	пашня
künnivares	грач
kunst	искусство
kunstlik	искусственный
kunstnik	художник
kuppel	купол
küpress	кипарис
Küpros	Кипр
küprose	кипрский
küproslane	киприот
küproslanna	киприотка
küps	зрелый (плод)
küpsis	печенье
kurat	Дьявол
kurat	чёрт
kuratlik	дьявольский
kurb	грустный
kurb	печальный
kurg	журавль
kuri	злой
kuristik	ущелье
kuritegu	преступление
kurjategija	преступник
kurjus	зло
kurk	огурец
kurnkopsik	дуршлаг
kursor	курсор
kurss	курс
kurss	курс (валют)
kursused	курсы
kursusekaaslane	однокурсник
kurt	глухой
kurttumm	глухонемой
kuru	перевал
kurv	поворот
kurv	поворот (место на дороге)
kurvastus	огорчение
kus	где
Kus?	Где?
kusi	моча
küsima	спрашивать
küsimärk	вопросительный знак
küsimus	вопрос
küsitlema	опрашивать
kuskil	где-то
kuskilt	откуда-нибудь
kuskilt	откуда-то
Kust?	Откуда?
kustunud vulkaan	потухший вулкан
kustutama	тушить
kustutama	тушить (пожар)
kustutama	удалять
kustutuskumm	ластик
kütma	топить печь
kutse	пригласительный билет
kutsikas	щенок
kutsuma	звать (на помощь и т.п.)
kutsuma	позвать
kutsuma	приглашать
kütt	охотник
küttimine	охота
kütus	горючее
kütus	топливо
kütus	топливо, горючее
kütusefilter	топливный фильтр
Kuu	Луна
kuu	месяц
kuu (kalendri)	месяц
kuu (taeva)	луна
kuu aega tagasi	месяц назад
kuu aja pärast	через месяц
Kuuba	Куба
kuuba	кубинский
kuubalane	кубинец
kuubalanna	кубинка
kuul	пуля
kuul	шар (в бильярде и т.п.)
kuul	ядро
kuulama	слушать
kuuli ajama	загнать шар
küülik	кролик
küülikukasvandus	крольчатник
küülikupoeg	крольчонок
kuulipilduja	пулемёт
kuullaager	подшипник
kuulma	слышать
kuulsus	слава (почёт)
kuuluma	принадлежать
kuulus	знаменитый
kuulus	известный
kuulutus	афиша
kuulutus	афиша (театральная)
kuum	горячий
kuum	горячий (напр. лоб)
kuum	жаркий
kuumus	жара
küünal	свеча
küünarnukk	локоть
küünarvars	предплечье
küünlajalg	подсвечник
kuup	куб
kuupäev	дата
kuupäev	число (день месяца)
kuupäevastatud	датироваться
kuupmeeter	кубический метр
kuur	сарай
kuus	шесть
küüs	ноготь
kuusk	ель
kuuskümmend	шестьдесят
küüslauk	чеснок
kuusteist	шестнадцать
kuut	конура
kuvar	дисплей
kuvar	монитор
Kuveit	Кувейт
kvartal	квартал
kvartett	квартет
kviitung	квитанция
laadija	грузчик
laadima	грузить
laadima	заряжать (оружие)
laadimisseade	зарядное устройство
laager	лагерь
läände	на запад
lääne-	западный
laanepüü	рябчик
läänes	на западе
lääs	запад
lääts	чечевица
laava	лава
labakindad	варежки
läbi	запад
läbi	через
läbi	через (о препятствии)
läbi jooksma	течь (протекать)
läbi peksma	избить
läbi põlema	перегореть (о лампочке)
läbi vaatama	рассмотреть (~ вопрос)
läbi vaatama	рассмотреть (вопрос и т.п.)
labidas	лопата
läbilõige	пересечение
läbiotsimine	обыск
läbipaistev	прозрачный
läbirääkimised	переговоры
läbirääkimisi pidama	вести переговоры
labor	лаборатория
labürint	лабиринт
lademed	залежи
ladu	склад (товары)
laenama	занимать (деньги)
laeng	заряд
laenutama	взять напрокат
laenutus	прокат
laev	корабль
laev	судно
laevaarst	судовой врач
laevaga	на корабле
laevasõidutee	фарватер
lagendik	поляна
lagi	потолок
laguun	лагуна
lähedal	близко
lähedal	рядом
lähedal	рядом (недалеко)
lähedale	недалеко (ехать, идти)
lähedane	ближний
lähedane	близкий
lähedane	близкий (недалёкий)
lähedane sugulane	близкий родственник
lahendama	решить (задачу)
lahendamine	решение (задачи)
lähetus	командировка
lähim	ближайший
lahing	бой
lahingumoon	боеприпасы
lahinguvarustus	доспехи
lähituled	ближний свет
laht	бухта
laht	залив
lahti keerama	откручивать
lahti olema	работать (о магазине)
lahti tegema	открывать (дверь и т.п.)
lahutama	развестись
lahutatud	разведённый
lahutus	развод
lai	широкий
laiali jagama	раздать (напр. листовки)
laine	волна
lainehari	гребень волны
laip	труп
laisk	ленивый
laiskus	лень
laiskvorst	лентяй
laius	ширина
laius	широта
lakk	грива
lakk	лак (для пола и т.п.)
lakkima	покрывать лаком
lamama	лежать (о предмете)
lamamistool	шезлонг
lambakasvatus	овцеводство
lambakoer	овчарка
lambaliha	баранина
lambatall	ягнёнок
lämbuma	задохнуться
lame	плоский
lammas	овца
lamp	лампа
lamp	светильник
lamp	фонарь
langema	опадать (о листьях)
langevari	парашют
langevarjur	парашютист
langust	лангуст
Laos	Лаос
laostuma	разориться
laostumine	разорение
lapp	тряпка
laps	ребёнок
lapsed	дети
lapsehoidja	няня
lapselaps	внук
lapselaps	внучка
lapselapsed	внуки
lapsendama	удочерить
lapsendama	усыновить
lärm	шум
lärmakas	шумный
lärmama	шуметь
laser	лазер
lask	выстрел
laskeava	бойница
laskesuusatamine	биатлон
laskma pildistada	фотографироваться
laskmine	стрельба
laskuma	спускаться
laskur	стрелок
laste-	детский
lastearst	педиатр
latern	фара
laternad	фары (свет)
laternapost	фонарный столб
Läti	Латвия
läti	латышский
latikas	лещ
lätlane	латыш
lätlanna	латышка
latv	верхушка (дерева)
laualamp	настольная лампа
lauatennis	настольный теннис
laud	СТОЛ
lauda kinni panema	забронировать столик
laul	песня
laulatussõrmus	обручальное кольцо
laulja	певец
lauljanna	певица
laulma	петь
laulmine	пение
laulurästas	певчий дрозд
laup	лоб
laupäev	суббота
laupäev	субота
lausmaa	равнина
lava	сцена
lavastaja	режиссёр
lävi	порог
laviin	лавина
Leedu	Литва
leedu	литовский
leedulane	литовец
leedulanna	литовка
Leena	Лена
leetrid	корь
leevike	снегирь
legend	легенда
lehekülg	страница
lehestik	листва
lehis	лиственница
lehitsema	листать
lehm	корова
lehmalaut	коровник
leht	лист
leht	лист (бумаги и т.п.)
leht	лист(растения)
lehtede langemine	листопад
lehtpuu	лиственное
lehvik	веер
lehvitama	махать (крыльями)
lehvitama	махать (рукой)
leib	хлеб
leid	находка
leidma	найти
leidma	находить
lein	траур
leitnant	лейтенант
leiukoht	месторождение
leiutaja	изобретатель
leivapood	булочная
leke	течь (утечка)
lend	полёт
lendama	летать
lendama	лететь
lendav taldrik	летающая тарелка
lendleht	листовка
lendur	лётчик
lendurimüts	шлем
lennujaam	аэропорт
lennuk	самолёт
lennukiga	самолётом
lennukikomandör	командир корабля
lennukipilet	авиабилет
lennukisse minek	выход (на посадку)
lennukissemineku talong	посадочный талон
lennukitrepp	трап (к самолету)
lennukompanii	авиакомпания
leopard	леопард
lepatriinu	божья коровка
leping	договор
lepingu objekt	предмет договора
lepp	ольха
leppima	мириться
lesima	лежать (о человеке)
lesk	вдова
lesk	вдовец
lest	камбала
lestad	ласты
lett	прилавок
levitama	распространять (~ листовки)
levitama	распространять (запах)
libe tee	скользкая дорога
liberaal	либерал
liberaalne	либеральный
liblikas	бабочка
liblikas	мотылёк
Liechtenstein	Лихтенштейн
lift	лифт
liftiga sõitma	ехать на лифте
ligi tulema	подходить (приближаться)
ligikaudne	приблизительный
ligikaudu	приблизительно
liha	МЯСО
lihakarn	мясная лавка
lihas	мышца
lihtne	лёгкий (простой)
lihtne	простой
lihtsustama	упрощать
lihunik	мясник
Liibanon	Ливан
liibanoni	ливанский
liibanonlane	ливанец
liibanonlanna	ливанка
Liibüa	Ливия
liider	лидер
liidriks olema	лидировать
liiga	СЛИШКОМ
liigendnuga	складной нож
liiklus	уличное движение
liikluseeskirjad	правила дорожного
liiklusmärk	знак
liiklusõnnetus	дорожное происшествие
liiklussõlm	развязка
liiklusummik	пробка (на дороге)
liikumatu	неподвижный
liikumatu	неподвижный (взгляд)
liilia	лилия
liim	клей
liin on kinni	занятый (о линии)
liinilaev	лайнер
liir	итальянская лира
liit	союз (группа фирм)
liiter	литр
liiv	песок
liivakell	часы песочные
liivapaber	наждачная бумага
lilla	лиловый
lillekimp	букет
lillepeenar	клумба
lillkapsas	цветная капуста
Limpopo	Лимпопо
limusiin	лимузин
lina	лён
linane	из льна
lind	птица
linn	город
linnalähedane	пригородный
linnalähedane asula	пригород
linnaosa valitsus	префектура
linnapea	мэр
linnaplaan	план города
linnatransport	городской транспорт
linnavalitsus	мэрия
linnuparv	стая (птиц)
linnupoeg	птенец
Linnutee	Млечный Путь
lintnuudlid	лапша
lipp	знамя
lipp	ферзь
lipp	флаг
lips	галстук
lisa	приложение (к договору)
lisajõgi	приток
lisajõud	подкрепление
lisama	добавлять
lisand	гарнир
Lissabon	Лиссабон
lita	блядь
litsents	лицензия
litter	шайба
lõbus	весёлый
lõbusõit	прогулка (поездка)
lõbustama	развлекать
lõbutsema	веселиться
lodi	баржа
loeng	лекция
logiraamat	судовой журнал
lõgismadu	гремучая змея
logotüüp	логотип
lõhe	лосось
lõhkeaine	взрывчатка
lõhki minema	лопнуть
lõhn	запах
lõhnama	пахнуть
loik	лужа (на полу и т.п.)
lõik	абзац
lõikama	резать
lõikama	срезать
lõikehaav	порез
Loire	Луара
lõke	костёр
lõks	ловушка
loll	дурацк
lomp	лужа (на улице)
London	Лондон
lonkama	хромать
loodus	природа
looduskaitse	охранять (природу)
looduskaitseala	заповедник
loodusvarad	природные ресурсы
loojang	закат
loojuma	сесть
löök	удар
lõoke	жаворонок
löökfilm	боевик
loom	животное
looma	создать
looma	сочинить (музыку)
looma	сочинить (стихи, песню)
lööma	бить (ударять)
lööma	забить
lööma	ударить
loomaaed	зоопарк
loomaarst	ветеринар
loomakasvataja	животновод
loomakasvatus	животноводство
loomalaps	детёныш
loomaliha	говядина
loomi pidama	разводить (животных)
loorber	лавровый лист
loosung	лозунг
lootma	надеяться
lootus	надежда
loož	ложа
lõpetama	заканчивать
lõpp	конец
lõpp	окончание
lõpp	окончание (конец)
lõpp-peatus	конечная остановка
lõpused	жабры
Los Angeles	Лос-Анджелес
loss	дворец
loss	замок
loterii	лотерея
lõualuu	челюсть
lõuend	холст
lõug	подбородок
lõuna	обед
lõuna	юг
lõuna-	южный
Lõuna-Aafrika Vabariik	ЮАР
Lõuna-Ameerika	Южная Америка
Lõuna-Korea	Южная Корея
lõunas	на юге
lõunasse	на юг
lõunat sööma	обедать
lõunavaheaeg	перерыв на обед
Lõvi	Лев
lõvi (isane)	лев
lõvikutsikas	львёнок
luba	разрешение (документ)
luba	разрешение (согласие)
lubadus	обещание
lubama	обещать
lubama	разрешать
lubama	разрешать (позволять)
lubama	разрешить
lubivärv	побелка(материал)
lugeja	читатель
lugema	считать (~ деньги)
lugema	считать (подсчитывать)
lugema	читать
lugemine	чтение
lugu	рассказ
Lugupeetud ...	Уважаемый ... (в письме)
lühiajaline	кратковременный
lühike	короткий
lühikest aega	недолго
lühikest kasvu	невысокого роста
lühinägelik	близорукий
lühiühendus	короткое замыкание
luht	луг
lühter	люстра
luik	лебедь
lukk	замок
lukk	замок (дверной ~)
lukksepp	слесарь
lukuauk	замочная скважина
lukust lahti keerama	отпереть
lüliti	выключатель
lülitus	подключение
lumehelbeke	снежинка
lumekoristusauto	снегоуборочная машина
lumelauasõit	сноуборд
lumeleopard	снежный барс
lumememm	снеговик
lumepall	снежок
lumesadu	снегопад
lumetorm	метель
lumi	снег
lumikelluke	подснежник
lunaraha	выкуп (плата)
lunaraha nõudma	требовать выкуп
lunastama	искупить
lunastamine	искупление
lund sajab	идёт снег
lusikas	ложка
lust	веселье
luteri kirik	Лютеранская церковь
luterlane	лютеранин
luu	кость
luud	веник
luud murdma	получить перелом
luuk	люк
luuk	люк (на дороге)
luukere	скелет
luule	поэзия
luuletaja	поэт
luuletus	стихотворение
luuletused	стихи
luumurd	перелом
luup	лупа
luup	шлюпка
luuraja	разведчик
luure	разведка
lüüs	шлюз
Luxembourg	Люксембург
Lyon	Лион
Maa	Земля
maa	страна
maa-alune käik	подземный ход
maadeavastamine	открытие (новых земель)
maadleja	борец
maadlus	борьба
määgima	блеять
maailm	мир (вся планета)
maailmaruum	космическое пространство
maak	руда
maakera	земной шар
maal	картина
maaler	маляр
maaletooja	дистрибьютор
maalikunst	живопись
maalinäitus	выставка картин
maamaja	загородный дом
maanduma	садиться (о самолёте)
maandumine	посадка
maandumisrada	посадочная полоса
maantee	шоссе
maapähkel	арахис
määrama	назначать (встречу)
määrama	назначать (на должность)
määrdunud	грязный
maarohtudest	травяной (чай и т.п.)
maarohud	лекарственная трава
määrsõna	наречие
maasikas	земляника
maastik	пейзаж
maastikumaal	пейзаж (картина)
maastur	внедорожник, джип
maavarad	полезные ископаемые
maavärin	землетрясение
Madagaskar	Мадагаскар
madal	мелкий
madal	мелкий (неглубокий)
madal	низкий
madalik	мель
madalik	отмель
madalikule jääma	сесть на мель
Madalmaad	Нидерланды
mädarõigas	хрен
madrats	матрас
Madrid	Мадрид
madrus	матрос
mäeahelik	горная цепь
mäeahelik	горный хребет
mäesuusatamiskuurort	горнолыжный курорт
mäetipp	пик
maffia	мафия
magada tahtma	хотеть спать
magama	спать
magama heitma	ложиться спать
magama jaama	заснуть
magama minema	идти спать
magamistuba	спальня
mage	пресная (о воде)
mage-	пресная (о воде)
mäger	барсук
mageveeline	пресноводный
mägi	гора
mägikits	серна
magma	магма
magnaat	магнат
magnet	магнит
magnetofon	магнитофон
magnoolia	магнолия
magu	желудок
magus	сладкий
magus	сладкий (о чае, кофе)
maha kustutama	стереть (~ надпись)
maha laskma	застрелить
maha laskma	расстрелять (казнить)
maha minema	сойти (с автобуса и т.п.)
maha raiuma	вырубать лес
maha tõmbama	зачеркнуть
maha valama	пролить
maha voolama	пролиться
maha võtma	снимать (убирать)
mahalaskmine	расстрел (казнь)
mahlapress	соковыжималка
maht	объём
mai	май
maikelluke	ландыш
maipõrnikas	майский жук
mais	кукуруза
maisihelbed	кукурузные хлопья
maismaa	земля, суша
maitse	вкус
maitseaine	приправа
maitseroheline	зелень
maitsev	вкусный
maja	дом
majakas	маяк
majandus	экономика
majanduskool	бизнес-школа
majanduslangus	экономический спад
majanduslik	экономический
majandusteadlane	экономист
majonees	майонез
major	майор
makaak	макака
makaronid	макароны
mäkketõus	восхождение
maks	налог
maks	печень
maksma	платить
maksma	стоить
maksmine	оплата
malaaria	малярия
malai	малайский
malailane	малаец
malailanna	малайка
Malaisia	Малайзия
male	шахматы
male	шахматы (игра)
malelaud	шахматная доска
malend	фигура (шахм.)
malendid	шахматы (фигуры)
mälestused	память (воспоминания)
mälestussammas	памятник
maletaja	шахматист
maleturniir	шахматный турнир
Malta	Мальта
malta	мальтийский
maltalane	мальтиец
maltalanna	мальтийка
mälu	память
mamma	мама
mammut	мамонт
mänd	сосна
mandariin	мандарин
mandlipähkel	миндаль
mäng	игра
mangaan	марганец
mängija	игрок
mängima	играть
mängima	играть (роль)
mango	манго
mangroovipuu	мангровое дерево
mänguautomaat	игральный автомат
mängufilm	художественный фильм
mängukonsool	игровая приставка
mängureeglid	правила игры
mängust	мангуст
manner	материк
manöövrid	манёвры
mantel	пальто
mapp	папка
mära	кобыла
märg	мокрый (промокший)
margareeta	маргаритка
margariin	маргарин
märge	пометка
märgistus	разметка
mari	ягода
marineeritud	маринованный
marjad	ягоды
märjaks saama	промокнуть
mark	марка
mark	немецкая марка
märkama	замечать (увидеть)
märkama	увидеть (заметить)
marker	маркер
märkimisväärne	значительный
märklaud	мишень
märkus	примечание
marmelaad	мармелад
marmor	мрамор
maroko	марокканский
Maroko	Марокко
marokolane	марокканец
marokolanna	марокканка
Marseille	Марсель
marslane	марсианин
marsruut	маршрут
Marss	Марс
marssal	маршал
marssima	маршировать
märts	март
marutaud	бешенство
masinakirjutaja	машинистка
masinaruum	машинное отделение
mask	маска
mass iteabeva hend id	масс медиа
massöör	массажист
massöör	массажистка
mast	мачта
mastaap	масштаб
Mastif	мастиф
matemaatika	математика
materjal	материал
matk	поход
matkaja	турист (в походе)
matma	хоронить
matt	мат
matt	матовый
matus	похороны
matusebüroo	похоронное бюро
mausoleum	мавзолей
medal	медаль
meditsiin	медицина
medõde	медсестра
meduus	медуза
meelde jätma	запомнить
meelde tuletama	напоминать
meelde tuletama	упоминать
meeldima	нравиться
meeldiv	приятный (голос)
meelega	нарочно
meelekoht	висок
meelespea	незабудка
meenutama	вспоминать
mees	муж
mees	мужчина
meeskond	экипаж
meeter	метр
meetod	метод
megabait	мегабайт
mehaanik	механик
mehaaniline	механический
mehele minema	выйти замуж
mehhiklane	мексиканец
mehhiklanna	мексиканка
Mehhiko	Мексика
mehhiko	мексиканский
meisterlikkus	мастерство
meistriteos	шедевр
meistrivõistlused	чемпионат
Meka	Мекка
Mekong	Меконг
melod raama	мелодрама
melon	дыня
memuaarid	мемуары
menuraamat	бестселлер
menüü	меню
mereannid	морепродукты
merehaigus	морская болезнь
meremees	моряк
meresõit	мореплавание
merevaik	янтарь
meri	море
merihobu	морж
merihobuke	морской конёк
merisiil	морской ёж
meritäht	морская звезда
Merkuur	Меркурий
mesi	мёд
mesilane	пчела
mesinädalad	медовый месяц
mesinik	пчеловод
metall	металл
metall-	металлический
meteoriit	метеорит
metroo	метро
metrooga sõitma	ехать на метро
mets	лес
metsa-	лесной
metsavahetee	просёлочная дорога
metsavaht	лесник
metsik	дикий
metsis	глухарь
metskits	косуля
metslinnud	дичь
metsloom	зверь
metsmesilane	шмель
metssiga	кабан
metsvint	зяблик
Mexico	Мехико
Miami	Майями
migratsioon	миграция
miil	миля
miin	мина
miin	миномётная мина
miinipilduja	миномёт
miiniväli	минное поле
miinus	минус
mikrofon	микрофон
mikrolaineahi	микроволновая печь
mikroob	микроб
mikroskoop	микроскоп
Miks?	Почему?
mikser	миксер
mikstuur	микстура
Millal?	Когда?
Mille jaoks?	Для чего?
millegi pärast	почему-то
Milleks?	Зачем?
millekski	зачем-то
millest tehtud	из (о материале)
Millest?	О чём?
milligramm	миллиграмм
millimeeter	миллиметр
milline	какой
mimoos	мимоза
mina	я
mind	меня
mineerima	заминировать
minema	идти
mineraal	минерал
mineraalvesi	минеральная вода
minestus	обморок
minevik	прошлое (сущ.)
miniatuur	миниатюра
minister	министр
minu arvates ...	по моему мнению ...
minu, enda	мои
minut	минута
mis	что (местоимение)
mis tahes	любой
mis, mida	что
Mis?	Который?
Mis?	Что?
misjonär	миссионер
miski	что-нибудь
miski	что-то
Mississippi	Миссисипи
Missugune?	Какой?
mitmesugune	разный
mitte keegi	никто
mitte kuhugi	никуда
mitte kunagi	никогда
mitte kuskil	нигде
mitte midagi	ничего
MITTE SEGADA	НЕ БЕСПОКОИТЬ
MITTE SUITSETADA!	НЕ КУРИТЬ!
Mitu?	СКОЛЬКО? (исчисл.)
Mjanma	Мьянма
mobiiltelefon	мобильный телефон
modell	модель (манекенщица)
modell	натурщик
modell	натурщица
modem	модем
moekunstnik	модельер
möirgama	реветь
mõistatus	загадка
mõistatust andma	загадывать загадку
mõiste	смысл (напр. слова)
mõiste	термин
mõistma	понять
mõistus	ум
mõju	влияние
mõjuma	влиять
molbert	мольберт
moldaavia	молдавский
moldaavlane	молдаванин
moldaavlanna	молдаванка
mölder	мельник
Moldova	Молдова
molekul	молекула
moment	момент
Monaco	Монако
monarh	монарх
mongol	монгол
mongoli	монгольский
mongolitar	монголка
Mongoolia	Монголия
mõnikord	иногда
monopol	монополия
Mont Blanc	Монблан
Montreal	Монреаль
mööbel	мебель
mood	мода
mööda sõitma	проезжать (миновать)
möödasõidu keeld	обгон запрещён
möödasõit	обгон
moodne	МОДНЫЙ
mõõdulint	рулетка
möödunud	прошедший
möödunud	прошлый
möödunud aastal	в прошлом году
möödunud kuus	в прошлом месяце
möödunud nädalal	на прошлой неделе
mõõk	меч
mõõk	шпага
moon	мак
mõõn	отлив
moos	варенье
mõõteriist	измерительный прибор
mõõtma	измерять
mootor	двигатель
mootor	двигатель, мотор
mootorimaht	объём двигателя
mootoriõli	масло моторное
mootorlaev	теплоход
mootorratas	мотоцикл
mops	мопс
mormoon	мормон
mormoonlus	Мормонство
mõru	горький
mõrv	убийство
mõrvar	убийца
mosaiik	мозаика
mošee	мечеть
Moskva	Москва
moslem	мусульманин
moslemi	мусульманский
motell	мотель
motiiv	мотив (преступления)
mõtlema	думать
motoroller	мотороллер
mõttekriips	тире
mõttesse jääma	задуматься
mugav	комфортабельный
mugav	удобный (мебель и т.п.)
mugavus	комфорт
Muhamed	Мухаммед
muhk	шишка
muide	кстати, ...
muinasjutt	сказка
muljutis	вмятина
mulla	мулла
muna	яйцо
munad	яйца
munakollane	желток
munakoor	скорлупа
munaroog	яичница
munast välja tulema	вылупляться
munavalge	белок
München	Мюнхен
mungaklooster	монастырь (мужской)
munk	монах
munstükk	мундштук
münt	монета
müokardi infarkt	инфаркт миокарда
murdma	ломать
murdma	сорвать (цветок)
murdmaasuusatamine	лыжные гонки
murdvaras	взломщик
mureen	мурена
murel	черешня
murelipuu	черешня
muretsema	волноваться
mürgine	ЯДОВИТЫЙ
mürgine seen	ядовитый гриб
mürgitus	отравление (пищевое)
mürgitust saama	отравиться (едой)
müristab	гремит гром
müristama	греметь (о громе)
mürkel	сморчок
mürsk	снаряд
mürsuauk	пробоина
muru	газон
musket	мушкет
musketär	мушкетёр
must	чёрное
must	чёрный
Must Jack	блэк джек
must kast	чёрный ящик
Must meri	Чёрное море
must pipar	чёрный перец
must sõstar	чёрная смородина
mustad	чёрные
mustang	мустанг
Müstik	ледник
mustikas	черника
mustkunstnik	фокусник
mustlane	цыган
mustlaslik	цыганский
mustlasnaine	цыганка
musträstas	чёрный дрозд
mutri võti	гаечный ключ
mutrivõti	гаечный ключ
müts	шапка
mutt	крот
mutter	гайка
muuja	продавец
muuja	продавщица
muul	мул
müüma	продавать
muuseum	музей
muusik	музыкант
muusika	музыка
muusikariist	музыкальный инструмент
müüt	миф
muutma	изменить (поменять)
naaber	сосед
naaber (nais soost)	соседка
naabri-	соседний
naabrid	соседи
naabrinaine	соседка
naarits	норка
naba	пупок
nädal	неделя
nädalavahetus	выходные
nael	гвоздь
nael	фунт (мера веса)
naelapea	шляпка (гвоздя)
naelsterling	фунт стерлингов
naer	смех
naeratama	улыбаться
naeratus	улыбка
naeris	репа
naerma	смеяться
naerma hakkama	засмеяться
nafta	нефть
nafta puurtorn	нефтяная скважина
naftajuhe	нефтепровод
nägema	видеть
nagi	вешалка (стойка)
nägu	ЛИЦО
nägu	морда
nägu pesema	умываться
nahast	из кожи
nahk	кожа
nahk	шкура (убитого животного)
nahkhiir	летучая мышь
nähtavus	видимость
näide	пример
näidend	пьеса
näidis	образец
naiivne	наивный
nailon	нейлон
nailonist	из нейлона
naine	жена
naine	женщина
Nairobi	Найроби
naist võtma	жениться
naistearst	гинеколог
näit	показание (прибора)
näit	показание (счётчика)
näitama	показать
näitama	показывать
näitama	указать (направление)
näitama	указать(направление)
näiteks	например
näitleja	актёр
näitleja	артист
näitlejanna	актриса
näitlejanna	артистка
näitus	выставка
nakatama	заразить (~ гриппом)
nakatuma	заразиться чем-л.
Näkineid	русалка
näkkima	клевать (о рыбе)
nakkus	инфекция
nali	шутка
nalja tegema	шутить
näljahäda	голод (бедствие)
naljakas	смешной
naljakas	смешной (анекдот)
naljakas	смешной (забавный)
naljakas	смешной (человек)
näljane	голодный
Namiibia	Намибия
näpits tangid	плоскогубцы
Napoli	Неаполь
napsiklaas	рюмка (стопка)
närima	грызть
närimiskumm	жевательная резинка
narkokaupmees	торговец наркотиками
narkomaan	наркоман
narkootik	наркотик
narrima	дразнить (обзывать)
närtsima	вянуть
nartsiss	нарцисс
närv	нерв
närveerima	нервничать
närvid	нервы
närviline	нервный
nastik	уж
natuke	немного ...
natüürmort	натюрморт
näuguma	мяукать
neem	мыс
neer	почка
negatiivne	отрицательный
Neitsi	Дева
neitsi	девственница
nekroloog	некролог
neli korda aastas	4 раза в год
neljapäev	четверг
nelk	гвоздика
nemad	они
Nepal	Непал
Neptuun	Нептун
neuroos	невроз
New York	Нью-Йорк
Newfoundland! koer	ньюфаундленд
Nice	Ницца
nihestama	вывихнуть
nihestus	вывих
nii	так
Niilus	Нил
niipalju	столько
niiske	влажный (климат)
niiskus	влажность
niit	нитка
niitma	косить (траву)
nikkel	никель
nimekiri	список
nimesilt	бэдж
nimetama	называть
nimetus	название
nimi	имя
nimi	кличка (животн.)
nimisõnad	существительное
nina	нос
ninasarvik	носорог
nirk	ласка
nisu	пшеница
niutsuma	скулить
noatera	лезвие (ножа)
nõel	игла (для шитья)
nõelama	жалить (о насекомом)
nõges	крапива
nõgu	впадина
nohu	насморк
nõid	ведьма
nõid	колдун
nokaut	нокаут
nokauti lööma	нокаутировать
nokdaun	нокдаун
nokk	КЛЮВ
nokkima	клевать
nõlv	СКЛОН
noodid	ноты
noogutama	кивнуть (в знак согласия)
nool	стрела
nool	стрелка
nööp	пуговица
nööpauk	петля (для пуговицы)
noor	молодой
nöör	верёвка
nöör	шнур (верёвка)
noorem poeg	младший сын
noorem tütar	младшая дочь
noorsõdur	новобранец
nooruk	подросток
noorus	юность
noppima	рвать (напр. цветы)
nõrk	слабый
nõrk	слабый (о ремне и т.п.)
nõrkus	недостаток (характера)
norm	норма (стандарт)
normaalne	нормальный
Norra	Норвегия
norra	норвежский
norralane	норвежец
norralanna	норвежка
norskama	храпеть
norskamine	храп
notar	нотариус
nõu	совет
nõu	сосуд
nõudepesumasin	посудомоечная машина
nõudma	настаивать (упорствовать)
nõudma	требовать
nõudmine	спрос
nõue	требование
nõunik	советник
nõupidamine	совещание
nõusolek	согласие
nõustuma	соглашаться
november	ноябрь
nuga	НОЖ
nuga	ножик
nugis	куница
nuhkima	шпионить
nulg	пихта
null	ноль
number	номер
number	номер (в гостинице)
number	номер (выступление)
number	номер (журнала)
number	номер (напр. автобуса)
nunn	монахиня
nunnaklooster	монастырь (женский)
nupp	кнопка
nüri	тупой
nüriks minema	затупиться
nurjumine	крах
nurk	угол
nurk	угол (дома)
nurk	угол (комнаты)
nurru lööma	мурлыкать
nutma	плакать
nutma hakkama	заплакать
nüüd	сейчас (в эту минуту)
nüüd	теперь
nuustik	губка
nuusutama	нюхать (о животных)
oaas	оазис
oad	бобы
obligatsioon	облигация
oboe	гобой
observatoorium	обсерватория
oda	копьё
oda	КОПЬё (спорт.)
oda	слон
odav	дешёвый
odav	дешёвый (о предмете)
odav	недорогой
odavnema	подешеветь
õde	сестра
oder	ячмень
öeldis	сказуемое
ohe	вздох
ohjad	вожжи
õhk	воздух
ohkama	вздохнуть
õhkpadi	воздушная подушка
õhku tõusma	взлетать
õhkutõusmine	взлёт
oht	опасность
ohtlik	опасный
õhtu	вечер
õhtul	вечером
õhtusöök	ужин
õhtust sööma	ужинать
õhuauk	воздушная яма
õhufilter	воздушный фильтр
õhuhäire	воздушная тревога
õhuke	тонкий
õhutõrjekahur	зенитка
ohutu	безопасный
ohver	жертва
ohverdama	пожертвовать (фигуру)
ohverdamine	жертвоприношение
ohvitser	офицер
oie	стон
õieleht	лепесток
oigama	стонать
õige	верный (правильный)
õige	правильный (верный)
õigeks ajaks	вовремя
õigeusk	Православие
õigeusklik	православный
õigeusukirik	Православная церковь
õiglane	справедливый
õiglus	справедливость
õigus	право
oinas	баран
õitsema	цвести
oja	ручей
okas	иголка
okas	шип (растения)
okaspuu	хвойное
okassiga	дикобраз
okastraat	колючая проволока
Okavango	Окаванго
ökoloogia	экология
oks	ветка
oks	сук
okse	рвота
oksjon	торги (аукцион)
oktoober	октябрь
õled	солома
Oled sa kindel?	Ты уверен?
olema	быть
olemas olema	существовать
olend	существо
õlg	плечо
õli	масло
õlifilter	масляный фильтр
oliivid	оливки
oliivõli	масло оливковое
õllebaar	пивная
olukord	обстановка
oluline	существенный
Olümpiamängud	Олимпийские игры
omadus	свойство
omadussõnad	прилагательное
omaette	про себя
omaette	про себя (читать)
omama	иметь
omand	собственность
omanik	владелец
õmblema	шить
õmblus	шов (швейный)
õmblusmasin	машинка (швейная)
omlett	омлет
on külm	холодно (о погоде)
on kuum	жарко (о погоде)
õng	удочка
õnge vette viskama	забросить удочку
õngekonks	крючок
õngekork	поплавок
õngenöör	леска
Õnn kaasa!	Удачи!
õnnelik	счастливый
õnneseen	удачливый (человек)
õnnestunud	удачный
õnnitlema	поздравлять
õnnitluskaart	поздравительная открытка
onu	дядя
onupoeg	двоюродный брат
onutütar	двоюродная сестра
öö	ночь
ööbik	соловей
ookean	океан
ööklubi	ночной клуб
öökull	сова
öökülmad	заморозки
ööpäev	сутки
ooper	опера
õõs	дупло
öösärk	ночная рубашка
öösel	ночью
ootama	ждать
ooteruum	зал ожидания
õõtssoo	трясина
operaator	оператор
operatiivmälu	оперативная память
operatsioon	операция (мед.)
operett	оперетта
õpetaja	учитель
õpetama	учить (об учителе)
õpetus	учения
õpik	учебник
õpik iseõppijaile	самоучитель
õpilane	ученик
õpilane	ученица
opositsioon	оппозиция
opositsiooniline	оппозиционный
õppeaine	предмет (дисциплина)
õppejõud	преподаватель
õppekirjandus lastekirjandus	учебная литература детская литература
õppima	учить (иностр. язык)
õppima	учить (что-л.)
õppima	учиться
õppima	учиться (чему-л.)
optika	оптика
orangutang	орангутанг
oranž	оранжевый
orav	белка
orb	сирота
orbiit	орбита
orbitaaljaam	орбитальная станция
orden	орден
orel	орган
organisaator	организатор
organisatsioon	организация (предприятие)
organiseeritud	организованный
organism	организм
orhidee	орхидея
ori	раб
originaal	оригинал
originaal	подлинник
originaaldokument	подлинный (документ)
orjus	рабство
orkaan	ураган
orkester	оркестр
õrn	нежный
õrnus	нежность
osa	роль
osa	часть (целого)
osa võtma	участвовать
osake	частица (часть чего-л.)
osakond	отделение
osapooled	стороны
osariik	штат (часть страны)
osavõtja	участник
osavõtt	участие
osavõtuavaldus	заявка на участие
oskama	уметь
Oslo	Осло
ost	покупка (предмет)
oste tegema	делать покупки
ostma	купить
ostma	покупать
osuti	стрелка (часов)
otse	напрямик
otse	прямо
otsima	искать
otsima	искать ...
otsima	искать, разыскивать
otsimisressurss	поисковый ресурс
otsing	поиск
otsus	решение
otsustama	решать (принимать решение)
otsustav	решительный
Ottawa	Оттава
õudne	страшный
õudne	ужасный
õudus	ужас
õudusfilm	фильм ужасов
õudusunenägu	кошмар
õun	яблоко
õunapuu	яблоня
ovaal	овал
ovaalne	овальный
ovatsioon	овации
paabulind	павлин
paak	бак
paanika	паника
paar	пара (обуви и т.п.)
päästeingel	ангел-хранитель
päästepaat	шлюпка спасательная
päästerõngas	спасательный круг
päästevest	спасательный жилет
päästja	спасатель
Päästja	Спаситель
päästma	спасать
paat	лодка
paber	бумага
paber-	бумажный
padi	подушка
padjapüür	наволочка
padrik	заросли
padrun	патрон
padrunisalv	магазин (автомата)
paduvihm	проливной дождь
paekivi	известняк
päev	день
päevalilleõli	подсолнечное масло
päevavari	зонт
päevik	дневник
päevik	ежедневник
päevitunud	загорелый
pagar	пекарь
pagas	багаж
pagas ikäru	тележка (для багажа)
pagasi käru	тележка для багажа
pagasi otsimine	розыск багажа
pagun	ПОГОН
paha	плохой
pahaloomuline	злокачественная
pahameel	возмущение
pahane olema	возмущаться
pähe õppima	учить наизусть
paigutama	располагать (размещать)
päike	солнце
päikesepatarei	солнечная батарея
päikeseprillid	очки (от солнца)
Päikesesüsteem	солнечная система
päikesetõus	восход солнца
päiksekell	часы солнечные
päikseline	солнечный (день)
päiksepaisteline	солнечный (день)
päiksepiste	солнечный удар
päiksevarjutus	солнечное затмение
pais	плотина
paistma	виднеться
paistma	показаться (появиться)
paistma	светить (о солнце)
paitus	палтус
paju	ива
pakane	мороз
päkapikk	гном
pakasene	морозный
pakikandja	носильщик
pakiruum	багажник
Pakistan	Пакистан
pakistani	пакистанский
pakistanlane	пакистанец
pakistanlanna	пакистанка
pakk	пачка (чая, сигарет)
pakkuma	предлагать
pakkumine	предложение
paks	ТОЛСТЫЙ
paks	толстый (слой)
palavik	лихорадка
Palestiina autonoomia	Палестина
palett	палитра
palgamõrvar	наёмный убийца
palgasõdur	наёмник
palju	много
paljud	многие
paljundama	размножить
palk	оклад
palkama	нанимать (работника)
pall	мяч
palm	пальма
paluma	просить
palve	молитва
palve	просьба
palverändamine	паломничество
palverändur	паломник
palvetama	молиться
Pamiir	Памир
Panama	Панама
panama	панамка
panda	панда
pangaautomaat	банкомат
pangakonto	счёт (в банке)
pangalaen	кредит
pangandus	банковский бизнес
pangatšekk	чек(банковский)
pank	банк
pankrot	банкротство
pankrotistuma	обанкротиться
pann	сковородка
panter	пантера
pantomiim	пантомима
panus	ставка
panust mustale panema	ставить на чёрное
panust punasele panema	ставить на красное
panust tegema	делать ставки
papa	папа
papagoi	попугай
papaia	папайя
papp	картон
papp-	картонный
pappel	ТОПОЛЬ
pappus	ХОХОЛОК
paprika	паприка
paraad	парад
paradiis	рай
Paraguai	Парагвай
paralleel	параллель
paralleelne	параллельный
parandama	исправлять (ошибку)
parandama	ремонтировать
parandamine	починка
paras olema	подходить (быть впору)
pärast	после
pärast	через ... (о времени)
pärast lõunat	после обеда
pardel	бритва
pardipoeg	утёнок
parem	правый
paremal	справа
paremale	вправо
paremale	направо
pärg	венок
Pariis	Париж
pärilik	наследственный
parim	лучший
pärima	наследовать
päriseks	насовсем
park	парк
parkima	парковать (машину)
parkima	парковаться
parkimise keeld	стоянка запрещена
parkla	автостоянка
parkla	паркинг, парковка
parkla	стоянка (авто)
pärlid	жемчуг
parmal	пряжка
pärn	липа
parool	пароль
part	утка
parter	партер
partii	партия
partii	партия (в игре)
partii	партия (груза)
partner	партнёр
partner	партнёр (соучредитель)
partnerlus	партнёрство
parukas	парик
parun	барон
parvlaev	паром
pass	паспорт
passikontroll	паспортный контроль
pastakas	шариковая ручка
pasteet	паштет
pastor	пастор
patarei	батарейка
patarei	батарея
patareid vahetama	поменять батарейку
patent	патент
patenti saama	патентовать
patrioot	патриот
patrull	патруль
patrullauto	патрульная машина
patrullima	патрулировать
pats	коса
patsient	пациент
patsutama	хлопать (по плечу и т.п.)
patt	грех
pätt	бездомный (сущ.)
pattu tegema	грешить
patustaja	грешник
patustaja	грешница
paus	пауза
paviljon	павильон
pea	голова
peaaegu	ПОЧТИ
peaauhind	главный приз
peaingel	архангел
peakokk	шеф-повар
peal	на (на чём-то)
peale kaebama	доносить (сделать донос)
peale selle ...	кроме того, ...
peale tungima	наступать
pealetung	наступление
pealik	вождь
pealinn	столица
pealkiri	заголовок
pealt kuulama	подслушивать
pealuu	череп
peamine	главный
peamine	основной
peaminister	премьер-министр
peaosa	главная роль
peapööritus	головокружение
peas olema	наизусть
peatama	остановить (для проверки)
peatee	главная дорога
peategelane	главный герой
peatoimetaja	главный редактор
peatorn	главная башня
peatugi	ПОДГОЛОВНИК
peatükk	глава
peatükk	глава (книги)
peatuma	останавливаться
peatuma	остановиться (в отеле)
peatumise keeld	остановка запрещена
peatus	остановка (~ автобуса)
peatus	остановка (в пути)
pedaal	педаль
pedagoog	учитель, педагог
pedagoogika	педагогика
peegel	зеркало
peekon	бекон
peenar	грядка
peenike	тонкий
peet	свёкла
pehme	мягкий
peitel	стамеска
peitma	прятать
Peking	Пекин
pekk	сало
pelikan	пеликан
pension	пенсия
pensionär	пенсионер
pensionile minema	уйти на пенсию
peopesa	ладонь
perekond	семья
perekondlik	семейный
perekonnanimi	фамилия
perekonnnimi	фамилия
peremees	хозяин (владелец)
periood	период
periood	период (хокк.)
perioodilised väljaanded	периодическое издание
perse	жопа
perspektiiv	перспективы
Peruu	Перу
pesa	гнездо
pesa punuma	вить гнездо
pesapall	бейсбол
pesapallimüts	бейсболка
pesapallur	бейсболист
pesema	мыть
pesema	мыться
pesu	бельё (одежда)
pesu pesema	стирать (бельё)
pesu pesema	стирать бельё
pesukaru	енот
pesukauss	таз
pesumasin	стиральная машина
pesupesemine	стирка
pesupulber	стиральный порошок
Peterburi	Санкт-Петербург
petersell	петрушка
petma	изменить
petma	обманывать
petma	разочаровать
petmine	измена
pettuma	разочароваться
pettumus	разочарование
pianist	пианист
pidev	постоянный (шум)
pidevalt	постоянно (все время)
pidu	веселье (радость)
pidupäev	праздничный день
pidur	тормоз
pidur	тормоза
pidurdama	тормозить
piduripedaal	педаль тормоза
pidžaama	пижама
pihlakas	рябина
pihtima	исповедоваться
pihtimus	исповедь
piibel	библия
piibli-	библейский
piiksuma	пищать (о птицах)
piiluma	подсматривать
piim	молоко
piinamine	пытка
piip	трубка
piiratud	ограниченный
piirdeaed	ограда
piire	бордюр
piiripääsuke	стриж
piiritus	спирт
piirivalvur	пограничник
piisama	хватать (быть достаточным)
piiskop	епископ
piison	бизон
piits	плётка
pikend usjuhe	удлинитель
pikk	длинный
pikk	длинный (путь)
pikka kasvu	высокая
pikka kasvu	ВЫСОКИЙ
pikksilm	подзорная труба
pikkus	длина
pikkus	долгота
piknik	пикник
pildistama	фотографировать
pilet	билет
pilet	билет (входной)
pilet	билет (на поезд и т.п.)
pileti hind	стоимость билета
piletikassa	билетная касса
piletikontroll	контроль (в транспорте)
pilge	насмешка
pilgutama	мигнуть
pilgutama	моргать
piljard	бильярд
piljard iauk	луза
piljardikuul	бильярдный шар
piljardiruum	бильярдная
pilk	взгляд (выражение лица)
pilkama	насмехаться
pilku heitma	взглянуть
pill	пилюля
pillama	ронять
piloot	пилот
pilotka	пилотка (воен.)
pilv	облако
pilv	туча
pilvelõhkuja	небоскрёб
pilves	облачный
pilvik	сыроежка
pilvitu	безоблачный
pime	слепой
pime	тёмный (о комнате)
pime (nägemisvõimetu)	тёмный
pinal	пенал
pind	заноза
pindala	площадь
pinge	напряжение
pingviin	пингвин
pink	скамейка
pinnale tõusma	всплывать (о подвод, лодке)
pintsak	пиджак
pintsel	кисть
pipar	перец
pipardama	перчить
piparmünt	мята
pipett	пипетка
pipratops	перечница
piraaja	пиранья
piraat	пират
piraatlus	пиратство
pirn	груша
pirnipuu	груша
pirukas	пирог
pisar	слеза
pistaatsiapähkel	фисташки
pistik	вилка
pistikupesa	розетка
pitsa	пицца
pitsabaar	пиццерия
pitsat	печать (на документе)
plaan	план
plaan	план (города и т.п.)
plaani täitma	выполнять план
plaaster	лейкопластырь
plaatina	платина
plahvatus	взрыв
plakat	плакат
planeerima	планировать
planeet	планета
plank	бланк (фирменный)
plasku	фляжка
plastik	пластик, пластмасса
plastik-	пластмассовый
platoo	плато
pleier	плеер
plekk	пятно
pliiats	карандаш
pliiats iteritaja	точилка
plombeerima	пломбировать (зубы)
plomm	пломба (на зубах)
ploom	слива
ploomipuu	слива
pluss	плюс
pluus	блузка
Pluuto	Плутон
põder	лось
põdravasikas	оленёнок
poeem	поэма
poeg	сын
poegi välja hauduma	высиживать яйца
põgenema	убежать (из тюрьмы)
põgenemine	побег (из тюрьмы)
põhi	дно
põhi	север
põhimõte	принцип
põhja	на север
põhja-	северный
põhja laskma	потопить (корабль и т.п.)
põhja minema	идти ко дну
Põhja-Ameerika	Северная Америка
Põhja-Jäämeri	Северный Ледовитый океан
Põhja-Korea	Северная Корея
Põhjanael	Полярная Звезда
põhjapõder	олень
põhjas	на севере
põhjus	причина
põhjustama	привело
pohlad	брусника
poi	буй
pöial	большой палец
põiktänav	переулок
poiss	мальчик
pojeng	ПИОН
põkkama	производить стыковку
põkkumine	стыковка
poks	бокс
poksija	боксёр
poksikinnas	боксёрская перчатка
polaar-	полярный
põld	поле
põldmari	ежевика
põldoad	бобы
põldpüü	куропатка
põletushaav	ожог
põlgama	презирать
põlgus	презрение
poliitik	политик
poliitika	политика
poliitika	политика (курс)
poliitiline	политический
politsei	полиция
politseijaoskond	полицейский участок
politseinik	полицейский
polk	полк
põllumajandus	сельское хозяйство
polt	болт
polüester	полиэстер
polüestrist	полиэстровый
polüetüleen	полиэтилен
polüglott	полиглот
polügoon	полигон
põlv	колено
põlvikud	гольфы (носки)
põlvkond	поколение
põlvpüksid	шорты
pomm	бомба
pommi heitma	сбросить бомбу
pommilennuk	бомбардировщик
pommitama	бомбить
pommitamine	бомбёжка (налёт авиации)
põnevusfilm	приключенческий фильм
poni	пони
poogen	смычок
pöök	бук
pool	половина
pool aastat	пол года
pool tundi	полчаса
poola	польский
Poola	Польша
poolaasta	полугодие
poolakas	поляк
poolatar	полька
pooldaja	сторонник
poolehoidja	фан, болельщик
poolkasukas	полушубок
poolsaapad	ботинки
poolsaar	полуостров
poolus	полюс
pöörama	поворачивать
pöörama	поворачивать (~ направо)
pööramine	спряжение
poord	борт
pöörmetuled	указатель поворота
põõsas	куст
põõsastik	кустарник
pootsman	боцман
popmuusika	поп-музыка
populaarne	популярный
põrand	пол
põrandaalune	подпольный
põrandalamp	торшер
porgand	морковь
põrgu	ад
põrsas	поросёнок
port	порт (комп.)
portfell	портфель
portree	портрет
portselan	фарфор
portselan-	фарфоровый
portsigar	портсигар
portsjon	порция
Portugal	Португалия
portugali	португальский
portugallane	португалец
portugallanna	португалка
poseerima	позировать
põsesarnad	скулы
posits ioneerima	позиционировать
posits ioneerimine	позиционирование
positsioon	позиция
põsk	щека
post	почта (сообщения)
post	столб
postiljon	почтальон
postkast	почтовый ящик
postkontor	почта
postulaat	постулат
poti	пики
pott	горшок
pott	кастрюля
põuane	засушливый (лето, период)
põud	засуха
praad	жаркое
praadima	жарить
prääksuma	крякать
praeahi	духовка
praegu	сейчас (в наше время)
praetud	жареный (на сковороде)
pragu	трещина
pragunema	трескаться
Praha	Прага
prahti maha viskama	сорить
praktika	практика
prantslane	француз
prantslanna	француженка
prantsuse	французский
Prantsuse Polüneesia	Французская Полинезия
Prantsusmaa	Франция
preemia	премия
prefekt	префект
presbüterlane	пресвитерианин
presbüterlaste kirik	Пресвитерианская церковь
presbüterlus	Пресвитерианство
president	президент
press	пресса
prillid	очки
prilliraamid	оправа
printer	принтер
prints	принц
printsess	принцесса
prisma	призма
probleem	проблема
produtsent	продюсер
professionaalne	профессиональный
professor	профессор
prognoos	прогноз
prognoosima	прогнозировать
programm	программа
programmeeria	программист
programmeerija	программист
programmeerima	программировать
progress	прогресс
prohvet	пророк
projekt	проект
projekteerima	проектировать
prokurör	прокурор
pronks	бронза
pronks-	бронзовый
pronks iaeg	Бронзовый Век
proov	проба (клеймо)
proov	репетиция
proovi tegema	репетировать
proovid	пробы
proovikabiin	примерочная
proovima	пробовать (пытаться)
propeller	пропеллер
prospekt	проспект
prostituut	проститутка
protest	протест
protestant	протестант
protestantism	Протестантство
protestantlik kirik	Протестантская церковь
protesteerima	протестовать
protseduur	процедура
protsendid	проценты (доход)
protsent	процент
protsess	процесс
provaider	провайдер
provokatsioon	провокация
prügi	мусор (отбросы)
prügi	мусор (отходы)
prügi	мусор (сор)
prügiämber	мусорное ведро
prügikonteiner	мусорный бак
prügikühvel	совок для мусора
prügimägi	свалка
prügišaht	мусоропровод
prügiurn	урна (для мусора)
prügivedu	вывоз мусора
pruun	коричневый
pruut	невеста
pruutpaar	молодожёны
pseudonüüm	псевдоним
psühhiaater	психиатр
psühholoog	психолог
psühholoogia	психология
publik	публика
pudel	бутылка
pudel	флакон
pudeliavaja	открывалка (для бутылок)
pudelikael	горлышко (бутылки)
puder	каша
pugema	льстить
püha	СВЯТОЙ (сущ.)
püha	священный
Püha Vaim	Святой Дух
püha vesi	святая вода
Pühakiri	Священное Писание
pühakoda	храм
pühapäev	воскресенье
puhas	чистый
puhastama	очищать
puhastama	чистить
puhkama	отдохнуть
puhkepäev	выходной день
pühkima	подметать
puhkpillid	духовые инструменты
puhkus	ОТДЫХ
puhkus	отпуск
puhkusel olema	быть в отпуске
puhuma	дуть
pühvel	буйвол
puiestee	бульвар
püksiauk	ширинка
püksid	брюки
puksiir	буксир
puksiirtross	буксировочный трос
puksima	буксовать
pulber	порошок
puljong	бульон
pull	бык
pullover	пуловер
pulmad	свадьба
pulss	пульс
pult	пулы
pump	насос
punane	красное
punane	красный
Punane meri	Красное море
punane pipar	красный перец
punane sõstar	красная смородина
punapea	рыжий (человек)
punetised	краснуха
pung	почка
punkt	очко
punkt	пункт (договора)
punkt	точка
punktiir	пунктир
püramiid	пирамида
Püreneed	Пиренеи
puri	парус
purikas	сосулька
purjelaev	парусник
purjelaud	серфинг
purjelaudur	серфингист
purjesport	парусный спорт
purk	банка (жестяная)
purk	банка (стеклянная)
purskkaev	фонтан
puru	крошка (хлеба и т.п.)
puruks litsuma	раздавить (~ насекомое)
purunema	разбиться
purunema	сломаться
purustama	разрушать
purustused	разрушения
püss	ружьё
püssipära	приклад
pussitama	зарезать
püssitoru	дуло
püssitoru	ствол
püstol	пистолет
putukas	насекомое
puu	дерево
puudel	пудель
püüdma	ловить
püüdma	пытаться
püüdma	стремиться (желать)
puuduma	отсутствовать
puuduma	пропускать (занятия и т.п.)
puuduma	пропускать (занятия)
puudutama	прикоснуться
puudutama	трогать
puuhalg	полено
puuk	клещ
puuma	пума
püünis	капкан
püüniseid üles panema	ставить капкан
puuõõs	дупло
puur	клетка
puur	сверло
puurima	сверлить
puurtorn	нефтяная вышка
puus	бедро
puussepp	плотник
puust	деревянный
püüton	ПИТОН
puuvili	фрукт
puuvill	ХЛОПОК
puuvillane	из хлопка
raadio	приёмник
raadio	радио
raadiojaam	радиостанция
raadiolaine	волна (радио)
raadioreklaam	реклама на радио
raadiosaatja	рация
raadiosõlm	радиорубка
raadius	радиус
rääkima	говорить
rääkima	говорить (разговаривать)
rääkima	говорить с ...
rääkima	разговаривать
raam	рама (картины)
raamat	книга
raamatukapp	шкаф (книжный)
raamatukauplus	книжный магазин
raamatukogu	библиотека
raamatukoguhoidja	библиотекарь
raamatupidaja	бухгалтер
raamatupidamine	бухгалтерия
raamaturiiul	полка (для книг)
rabi	раввин
rada	тропа
radiaator	радиатор
radikaalne	радикальный
radist	радист
ragbi	регби
ragin	треск
rägisema	трещать (доски, лёд)
raha	деньги
rahakott	кошелёк
rahalised vahendid	денежные средства
rahavahetus	обменный пункт
rahe	град
rahet sajab	идёт град
rahhiit	рахит
rähn	дятел
rahu	мир (спокойствие)
rahu (riikide vaheline)	мир
rahuldama	удовлетворять
rahuldav	удовлетворённый
rahuldus	удовлетворённость
rahulik	спокойный
rahulolev	довольный
rahustama	успокаивать
rahustama	успокаивать (унять)
rahvad	народы
rahvas	народ
rahvus	национальность
rahvus	нация
rahvuslik	национальный
rahvusvaheline	международный
raidkuju	статуя
raisakull	гриф
raiuma	рубить (дерево)
rakett	ракета
ralli	ралли
rand	побережье
rändtirts	саранча
rändtsirkus	цирк-шапито
randuma	причаливать
rändur	путешественник
range	строгий
ränk	тяжкий (о преступлении)
ranne	запястье
rannik	берег (моря)
raport	рапорт
raputama	трясти
rase	беременная
raske	трудный
raske	тяжёлый (напр. груз)
raske	тяжёлый (о ранении)
raske (kaalult)	тяжёлый
raske (keeruline)	трудный
raskejõustik	тяжёлая атлетика
raskekaal	тяжелый вес
rasketööstus	тяжелая промышленность
raskeveohobune	тяжеловоз
raskus	трудность
rassism	расизм
rassist	расист
rästas	дрозд
rästik	гадюка
rasvad	жиры
rasvane	жирный (о пище)
ratas	колесо
rätik	платок (головной)
ratsahobune	скаковая лошадь
ratsasport	конный спорт
ratsavõistlused	скачки
ratsu	конь
ratsutaja	наездник
raud	железо
raudne	железный
raudrüü	кольчуга
raudteejaam	вокзал (ж/д)
raund	раунд
ravim	лекарство
ravima	лечить (болезнь)
ravima	лечить (ухаживать)
ravimine	лечение (больных)
reaktsioon	реакция
reamees	рядовой
reanimatsioon	реанимация
rebane	лиса
rebasekutsikas	лисёнок
redel	лестница (переносная)
redis	редис
reede	пятница
reegel	правило
reeglid	правила
reetlikult	вероломно
reetmine	предательство
reform	реформа
regioon	регион
registreerima	зарегистрироваться
registreerima	регистрировать
registreerimine	регистрация
registreerimisele^	стойка регистрации
registreerimistasu	регистрационный взнос
reguleerima	регулировать (прибор)
reguleerimine	регулировка
reha	грабли
rehv	покрышка, шина
Rein	Рейн
reis	путешествие
reis	рейс
reisibüroo	турагентство
reket	ракетка
reket	рэкет
reklaam	реклама
reklaam	реклама (объявление)
reklaamikampaania	рекламная кампания
reklaamikilp	рекламный щит
reklaamima	рекламировать
reklaamiplakat	рекламный плакат
reklaamtahvel	рекламный щит
rekord	рекорд
rekordit püstitama	ставить рекорд
religioon	религия
religioosne	религиозный
relv	оружие
relva käsitlema	обращаться (с оружием)
relvastatud	вооружённый
relvituks tegema	обезоружить
remont	ремонт
remonti tegema	делать ремонт
remontima	ремонтировать
repertuaar	репертуар
reportaaž	репортаж
reporter	репортёр
repro	репродукция
reputatsioon	репутация
reserveerima	резервировать
reserveerima	резервировать (~ стенд)
ressursid	ресурсы
restoran	ресторан
retsept	рецепт
retsept	рецепт (кулинарн.)
reuma	ревматизм
revolutsioon	революция
režiim	режим
ribakardinad	жалюзи
rida	ряд
rida	строка
riff	риф
rihm	ремень (сумки)
riided	одежда
riidehoiunumber	номерок (для пальто)
riidekapp	шкаф (для одежды)
riidest	из ткани
riietehoid	гардероб
riietelaenutus	прокат одежды
riieteparandus	ремонт одежды
riietus	одежда
riigihümn	государственный гимн
riigijuht	руководитель страны
riigikogu	парламент
riigipiir	граница
riigipööre	переворот
riigivapp	национальный герб
riik	государство
riik	страна
riis	рис
riiul	этажерка
riiv	задвижка
riiv	засов
riivima	тереть (на тёрке)
rikas	богатый
rike	неисправность
rikkis	быть сломанным
rind	грудь
rind	грудь (женская)
ring	круг
ring	ринг
ringjoon	окружность
ringliiklus	круговое движение
rinnahoidja	бюстгальтер
rinnakuju	бюст
rinnalaps	грудной ребёнок
rinne	фронт
Rio de Janeiro	Рио-де-Жанейро
ripse	ресница
risk	риск
riskantne	рискованный
riskima	рисковать
rist	крест
risti	трефы
ristiretk	крестовый поход
ristirüütel	крестоносец
ristkülik	прямоугольник
ristkülikuline	прямоугольный
ristleja	крейсер
ristluud	поясница
ristmik	перекрёсток
ristsõna	кроссворд
ritsikas	сверчок
rituaalne	ритуальный
robot	робот
rõdu	балкон
roheline	зелёный
rohi	трава
rohima	полоть
rõhk	давление
rõhk	ударение
röhkima	хрюкать
rõhknael	кнопка
rohulible	травинка
rohupudel	пузырёк
rohutirts	кузнечик
roie	ребро
rokkansambel	рок-группа
rokkmuusika	рок-музыка
romaan	роман
romb	ромб
rong	поезд
rongiga	поездом
ronk	ворон
rööbaspuud	брусья
rood	рота
roog	блюдо
roog	блюдо (кушанье)
rool	руль(велосипеда)
rool, rooliratas	руль, рулевое колесо
rõõm	радость
rõõm	радость (при встрече)
Rooma	Рим
rooma	римский
Rooma paavst	Папа Римский
roomama	ползать
roomlased	римляне
rõõmus	радостный
rõõmustama	радоваться
roos	роза
roosa	розовый
roosipõõsas	розовый куст
rooste	ржавчина
roostetama	ржаветь
roostetanud	ржавый
rootsi	шведский
Rootsi	Швеция
rootsi laud	шведский стол
rootslane	швед
rootslanna	шведка
röövel	грабитель
röövija	похититель (людей)
röövima	грабить
röövima	похитить (кого-л.)
rosinad	изюм
röster	тостер
rott	крыса
Rotveiler	ротвейлер
rubiin	рубин
rubriik	рубрика
rühm	отряд
rukis	рожь
rukkilill	василёк
rulett	рулетка
rumal	глупый
Rumeenia	Румыния
rumeenlane	румын
ründama	штурмовать
rünnak	атака
rünnak	штурм
rusikas	кулак
rütm	ритм
ruttama	спешить (торопиться)
ruupor	рупор
ruut	квадрат
rüütel	рыцарь
ruutmeeter	квадратный метр
ruutu	бубны
sa, sina	ты
saabel	сабля
saabuma	приезжать
saabuma	прилететь
saabumine	прилёт
saabumisaeg	время прилёта
saade	трансляция
saag	пила
saagima	пилить
saaja	получатель
šaakal	шакал
saama	становиться (сделаться)
saapad	сапоги
saar	остров
saar	ясень
säär	нога (выше ступни)
sääremari	икра
saarmas	выдра
sääsk	комар
saatan	Сатана
saatanlik	сатанинский
saatejuht	ведущий (тв)
saateleht	накладная
saatja	отправитель
saatma	отправить
saatma	отправлять
saatma	провожать
saatma	сопровождать
saatmine	отправка (письма)
saatus	судьба
saatus	судьба (доля, участь)
saavutama	достигать (результата)
saba	хвост
sadam	гавань
sadam	порт
sadam	причал
sadul	седло
sadulasse istuma	сесть в седло
saduldama	оседлать
safari	сафари
safiir	сапфир
safran	шафран
säga	сом
sagedane	частый
sageli	часто
sahk	плуг
šaht	шахта (скважина)
sahtel	ящик (стола)
säilima	сохраниться
säilitama	сохранять
säilitama	сохранять (~ мир)
sajand	век (столетие)
saksa	немецкий
Saksamaa	Германия
sakslane	немец
sakslanna	немка
saksofon	саксофон
saladus	секрет
saladus	тайна,секрет
salajane	секретный
salakaubandus	контрабанда (действия)
salakaubavedaja	контрабандист
salakaup	контрабанда (товары)
salakütt	браконьер
salamander	саламандра
salapärane	загадочный
salat	салат
salat	салат (латук)
sale	стройная
sall	шарф
salto	сальто
salu	роща
salv	мазь
salvestama	сохранить
salvrätik	салфетка
samblik	лишайник
samet	бархат
samm	шаг
sammal	мох
sammas	колонна
šampoon	шампунь
šampus	шампанское
samuti	также
sandaalid	сандалии
sandiks peksma	изувечить
säng	русло
Sansibar	Занзибар
šanss	шанс
šantaaž	шантаж
šantažeerija	шантажист
šantažeerima	шантажировать
sapöör	сапёр
sarapuupähkel	орех (лесной)
sardiin	сардина
särk	рубашка
sarnane	похожий
sarv	рог
satelliit	спутник
satelliittelevisioon	спутниковое телевидение
Saturn	Сатурн
Saudi Araabia	Саудовская Аравия
saun	сауна
savann	саванна
savi	глина
savi-	глиняный (о посуде)
seade	прибор
seadmed	оборудование
seadus	закон
seaduseelnõu	законопроект
seaduslik	законный
seal	там
sealiha	свинина
sealt	оттуда
seatina	свинец
sebra	зебра
sedel	записка
see	это
See on kallis.	Это дорого
seebikarp	мыльница
seeder	кедр
seelik	юбка
seemisnahk	замша
seen	гриб
seenejalg	ножка (гриба)
seenekübar	шляпка (гриба)
seep	мыло
seeria	серия (ряд)
seeria	серия (часть фильма)
seersant	сержант
seesamiseemned	кунжут
seest	из (откуда-то)
seest	изнутри
šeff	шеф
segama	беспокоить (мешать)
segi ajama	путать (ошибаться)
segment	сегмент
seib	шайба
seiklus	приключение
seiklused	приключения
sein	стена
seinakell	часы настенные
Seine	Сена
seire	мониторинг
seis	счёт
seis	СЧёТ (спорт.)
seisak	остановка (мотора)
seisak	остановка (перерыв)
seisma jätma	глушить (мотор)
seisukoht	точка зрения
seisund	состояние (больного)
seisupidur	стояночный тормоз
sekretär	секретарь
sektor	сектор
sektsioon	секция
sekund	секунда
sekvoia	секвойя
sel aastal	в этом году
seletama	объяснять
selg	спина
selga proovima	примерить
Selge!	Ясно! (понятно)
selgroog	позвоночник
selgroolüli	позвонок
seljakott	рюкзак
seljatugi	спинка (сиденья)
seljatugi	спинка (стула и т.п.)
sellepärast	поэтому ...
seller	сельдерей
selles kuus	в этом месяце
semikoolon	точка с запятой
senaator	сенатор
Senegal	Сенегал
sensatsioon	сенсация
sentimeeter	сантиметр
sepavasar	кувалда
sepp	кузнец
september	сентябрь
šerif	шериф
sertifikaat	сертификат
serv	подача
servima	подавать
sest...	потому, что ...
sfäär	сфера
Shanghai	Шанхай
siberi husky	хаски
sibul	клубень
sibul	лук (луковица)
side	бинт
side	связь
sidekriips	дефис
Sidney	Сидней
sidrun	лимон
siduma	перевязать
siduma	связывать
sidumine	перевязка
sidur	сцепление
siduriketas	диск сцепления
siduripedaal	педаль сцепления
šiffer	шифр
siga	свинья
sigala	свинарник
sigar	сигара
sigarett	сигарета
signaal	сигнал
signaal	сигнал (авто)
signaal	сигнал (клаксон)
signaali andma	сигналить (авто)
signaali andma	сигналить (гудеть)
signaalrakett	сигнальная ракета
signalisatsioon	сигнализация
sihik	прицел
sihikule võtma	навести (орудие)
sihikule võtma	навести(орудие)
sihtima	целиться (в ...)
sihtmärk	цель (при стрельбе)
sihvakas	стройный
sihverplaat	циферблат
siia	сюда
siid	шёлк
siidi-	шёлковый
šiiit	шиит
šiiitlus	Шиизм
siil	ёж
siin	здесь
siiralt	искренне
siiras	искренний
siirup	сироп
siirus	искренность
siis	тогда
siit	отсюда
sild	мост
sile	гладкий
silinder	цилиндр
silitama	гладить (ласкать)
silm	глаз
silma paistma	отличаться (от чего-л.)
silmaarst	окулист
silmad	глаза
silmalaug	веко
silmapiir	горизонт
silmapilk	мгновение
silmapilkselt	мгновенный
silmas pidama	подразумевать
silmatera	зрачок
silp	слог (часть слова)
silt	вывеска
SIM-kaart	SIM-карта
šimpans	шимпанзе
sinep	горчица
Singapur	Сингапур
sinikaelpart	селезень
sinikas	синяк
sinine	синий
sink	ветчина
sink	окорок
sinna	туда
sipelgapesa	муравейник
sipelgas	муравей
sireen	вой сирены
sireen	сирена
sireeni sisse lülitama	включить сирену
sirge	прямой
sirgjoon	прямая (сущ.)
siristama	стрекотать
siristama	чирикать
sirkel	циркуль
sisaldama	включать (о цене)
sisalik	ящерица
sisearst	терапевт
sisemine	внутренний
sisenema	сесть (в автобус и т.п.)
sisetelefon	домофон
sisse	в (предлог движения)
sisse hingama	сделать вдох
sisse kirjutama	вписывать (в список)
sisse lülitama	включать
sisse lülitama	включать (напр. радио)
sisse lülitama	включить
sisse lülitama	включить (приёмник)
sisse lülitama	подключиться
sisse pakkima	заворачивать (в бумагу)
sisse sõitma	врезаться (о машине)
sisse tulema	войти (в комнату и т.п.)
sisse tulema	входить (в комнату и т.п.)
sisse tungima	проникать
sisse vedama	импортировать
sissehingamine	вдох
sissejuhatus	введение
sissepääs	вход
sissepääsuluba	пропуск (документ)
sissesõidu keeld	въезд запрещён
sissevedaja	импортёр
sissevedu	импорт
sissevedu	импортный
sisu	содержание (список)
sisukord	оглавление
sitaseen	поганка
sitikas	жук
situatsioon	ситуация
skaala	шкала
skafander	скафандр
skandaal	скандал
skandaal	скандал (ссора)
skandaali tegema	скандалить
skandaalne	скандальный
skeem	схема (метро и т.п.)
skisofreenia	шизофрения
skleroos	склероз
Skorpion	Скорпион
skulptor	скульптор
skulptuur	скульптура
skumbria	скумбрия
skunk	скунс
slaalom	слалом
slaavlased	славяне
smaragd	изумруд
smoking	смокинг
SMS-sõnum	SMS-сообщение
snaiper	снайпер
sõber	друг
sõber	приятель
sõber olla	дружить
sõbranna	подруга
sõbranna	приятельница
sõda	война
sõda kuulutama	объявить (войну)
sõdima	воевать (вести войну)
sõdur	солдат
soe	тёплый
soe	тёплый (день)
soe	тёплый (день, пища)
soe vesi	горячая вода
soeng	причёска
sõidu keeld	движение запрещено
sõiduplaan	расписание
sõimama	ругать
sõimama	ругаться (на кого-л.)
sõit	поездка
sõitma	ехать
soja	соя
sõjakuulutamine	объявление войны
sõjamees	воин
sõjasaak	добыча
sõjaseisukord	военное положение
sõjaväebaas	военная база
sõjaväelane	военный
sõjaväeline riigipööre	военный переворот
sõjavang	пленный (сущ.)
šokeerima	шокировать
sokid	носки
sokk	козёл
šokk	шок
šokolaad	шоколад
šokolaadi-	шоколадный
soldat	валет
sõlm	узел (завязать ~)
sõltuma	зависеть (от ...)
solvama	обидеть
solvama	оскорблять
solvamine	оскорбление
solvatud	оскорбленный
solvuma	обидеться
solvumine	обида
sompus	пасмурный
sõna	слово
sõna	слово (единица речи)
sõna kuulma	слушаться (совета)
sõna tüvi	корень слова
sõnajalg	папоротник
sõnaraamat	словарь
sõnaühend	словосочетание
sõnavahe	пробел (между словами)
sõnavara	лексика
soni	кепка
sonima	бредить (мед.)
Sõnn	Телец
sõnnik	навоз
sõnum	заметка (в газете)
SOO	болото
soobel	соболь
söödav seen	съедобный гриб
soodustariif	экономичный
söögiisu	аппетит
söögituba	столовая (комната)
soojendama	нагревать
soojendama	разогревать
soojendus	разминка
soojus	тепло (о погоде)
söök	еда
sool	соль
soolama	солить
soolane	солёный
soolatoos	солонка
soolestik	кишечник
soolikas	кишка
sööma	есть, кушать
sööma	кушать, есть
Soome	Финляндия
soome	финский
soomlane	финн
soomlanna	финка
soomus	чешуя
soomuskate	панцирь (черепахи)
sõõrmed	ноздри
sööt	корм
sööt	наживка
söötma	кормить
SOOV	пожелание
soovima	желать
soovima	пожелать
soovitama	рекомендовать
soovitama	советовать
šoppamine	шоппинг
sõprus	дружба
sõrm	палец
sõrmejäljed	отпечатки пальцев
sõrmkindad	перчатки
sõrmus	КОЛЬЦО
sorteerima	сортировать
SOS	SOS
sosin	шёпот
sosistama	шепнуть
sosistama	шептать
šoti	шотландский
Šotimaa	Шотландия
šotlane	шотландец
šotlanna	шотландка
sotsialism	социализм
sotsialistlik	социалистический
sõudmine	гребля
Soul	Сеул
spagetid	спагетти
spetsiaalne	специальный
spidomeeter	спидометр
spikker	шпаргалка
spinat	шпинат
spionaaž	шпионаж
spioon	шпион
spits	шпиц
spordiala	вид спорта
spordiauto	спортивный автомобиль
spordisaal	спортзал
spordisaal	тренажёрный зал
sporditarvete kauplus	спортивный магазин
sportlane	спортсмен
staadion	стадион
staap	штаб
stabiilne	стабильный
stabiilsus	стабильность
standard	стандарт
standardne	стандартный
start	старт
start	старт (ракеты)
stend	выставочный стенд
stepler	степлер
stepp	степь
stiil	стиль
stipendium	стипендия
stjuardess	стюардесса
Stockholm	Стокгольм
stomatoloog	стоматолог
stopp-signaal	стоп-сигнал
strateegia	стратегия
streikija	забастовщик
stress	стресс
stseen	сцена (действие)
stsenaarium	сценарий
stsenarist	сценарист
subtiitrid	субтитры
süda	сердце
südametunnistus	совесть
sügav	глубокий
sügavik	бездна
sügavus	глубина
sügis	осень
sügisel	осенью
sügisene	осенний
sugu	пол (муж. или жен.)
suguharu	племя
sugulane	родственник
sugulased	родные (родственники)
sugupuu	родословная (собаки)
suhkrutoos	сахарница
suhkur	сахар
suhtlema	общаться
suhtlemine	общение
suits	дым
suitsetaja	курильщик
suitsetama	курить
suitsetama hakkama	прикурить
suitsetamine	курение
suitsupääsuke	ласточка
suitsupakk	пачка (сигарет)
suitsutatud	копчёный
sukad	чулки
sukelduja	ныряльщик
sukelduma	нырять
sukkpüksid	КОЛГОТКИ
sulam	сплав
sülearvuti	ноутбук
sulejope	пуховик
sulepea	перьевая ручка
sulepea	ручка
sulestik	оперение
sulg	перо (птицы)
sulgema	закрывать
sulgema	закрыть
sulgpall	бадминтон
sulgudes	в скобках
suli	шулер
sülitama	плевать
sulud	скобки
sümfoonia	симфония
summa Kui palju?	сумма Сколько? (о деньгах)
summutaja	глушитель
sümptom	СИМПТОМ
sünagoog	синагога
sündima	родиться
sündmus	событие
sündmuspaik	место преступления
sünge	мрачный (тёмный)
sünniaeg	дата рождения
sunniit	суннит
sünnikoht	место рождения
sünnimärk	родинка
sunnism	Суннизм
sünnitama	рожать
sünnitus	роды
sünonüüm	синоним
süntees	синтез
supermarket	супермаркет
supikulp	половник
supilusikas	столовая ложка
suplema	купаться
suplema	купаться (в море и т.п.)
supp	суп
surema	умереть
surilina	саван
Suriname	Суринам
surm	смерть
surmanuhtlus	смертная казнь
surnud	мёртвый
suru-jugapump	инжектор
süsi	уголь
susisema	шипеть
süsivesikud	углеводы
sussid	тапочки
süst	укол (мед.)
süstal	шприц
süsteem	система
süstima	делать укол (кому-л.)
sutenöör	сутенёр
suu	рот
süü	вина (ошибка, проступок)
süüa tahtma	хотеть есть
süüa tegema	готовить (обед)
süüa tegema	готовить (ужин)
süüa tegema	готовить(обед)
suubuma	впадать в ... (о реке)
süüde	зажигание
süüdi mõistma	приговорить
süüdistama	обвинять
süüdistatav	обвиняемый
süüdistus	обвинение
süüdlane	виновник
suudlema	целовать
suudlema	целоваться
suudlus	поцелуй
süüfilis	сифилис
suukorv	намордник
suulagi	нёбо
suunama	направлять
suunatuli	переключатель
suund	направление
suur	большой
suur	крупный (о фирме)
suur algustäht	большая буква
Suur Vanker	Большая Медведица
Suurbritannia	Великобритания
suurendama	увеличивать
suurenema	увеличиваться
suurepärane	великолепный
suurepärane	превосходный
Suurepärane!	Отлично!
Süüria	Сирия
suurmeister	гроссмейстер
suursaadik	посол
suursaatkond	посольство
suursugune	величественный
suurtükiväelane	артиллерист
suurtükk	пушка, орудие
suurus	размер (предмета)
suurvesi	половодье
suusad	ЛЫЖИ
suusakepid	палки (лыжные)
suusataja	лыжник
suusatama	кататься на лыжах
süütama	зажечь (костёр, камин)
süüteküünal	свеча зажигания
süütõend	улика
süütu	невиновный
süütunne	вина (чувство вины)
suvel	летом
suveniir	сувенир
suveniirikauplus	магазин сувениров
suvi	лето
suvine	летний
süžee	сюжет
Šveits	Швейцария
Šveits lanna	швейцарка
šveitsi	швейцарский
šveitslane	швейцарец
sviiter	свитер
tääk	штык
Taani	Дания
taani	датский
taanlane	датчанин
taanlanna	датчанка
tabalukk	навесной замок
tabama	попасть (в цель)
tabamine	точный (попадание)
tabel	таблица
tabel	табличка
tablett	таблетка
tabloo	табло
tädi	тётя
tadžiki	таджикский
Tadžikistan	Таджикистан
tadžikitar	таджичка
tadžikk	таджик
taevas	небо
Taevas, Taevariik	Небо, Царство Небесное
taga	сзади (находиться)
tagaajamine	погоня
tagala	тыл
tagama	гарантировать
taganema	отступать
taganemine	отступление
tagant	сзади (подойти)
tagaotsimine	розыск
tagasi	назад
tagasi	назад (движение)
tagasi	обратно
tagasi andma	отдать (вернуть)
tagasi hoidma	удерживать (~ от чего-л.)
tagasi lükkama	отклонить (просьбу)
tagasi saatma	отправить обратно
tagasi tulema	возвращаться
tagasihoidlik	скромный
tagasihoidlikkus	скромность
tagasikäik	задний ход
tagasikäik	фонарь заднего хода
tagasipöördekoht	разворот
tagastama	вернуть
tagavararatas	запасное колесо
tagaveoga	заднеприводный
tagumik	зад
tagumine	задний
taha jääma	отставать
tahavaatepeegel	зеркало заднего вида
tähendama	означать
tähestik	алфавит
täht	буква
täht	звезда
täht (kirja)	буква
tähtaeg	срок (долгий ~)
tähtis	важный
tähtkuju	созвездие
tahtma	хотеть
tahvel	доска (школьная)
Tai	Таиланд
tai	тайский
Taibei	Тайпей
täidis	начинка
täidlane	полный (толстый)
täiendav	дополнительный
taifuun	тайфун
tailane	таец
tailanna	тайка
taim	растение
taimekaitse	охрана(растений)
taimeõli	масло растительное
taimetoitlane	вегетарианец
taimetoitluslik	вегетарианский
täis	полный (наполненный)
täis puhuma	надувать
täis pumpama	накачивать (шину)
täishäälik	гласный звук
täisnurk	прямой угол
täispuhutav	надувной (~ матрас)
täisveoga	полноприводный
täitma	заполнить (~ анкету)
täitma	заполнить (документ)
täitma	наполнять
Taivan	Тайвань
taivani	тайванский
taivanlane	тайванец
taivanlanna	тайванка
takistus	препятствие
täkk	жеребец
taksikoer	такса
takso	такси
taksoga	на такси
taksojuht	таксист
taksomeeter	счётчик километража
taksopeatus	стоянка такси
taksot välja kutsuma	вызвать такси
taksot võtma	взять такси
taktika	тактика
taktitundetu	нескромный
taldrik	тарелка
talje	талия
taltsutaja	укротитель
taltsutama	приручать
talumees	крестьянин
talunaine	крестьянка
talunik	фермер
talv	зима
talvel	зимой
talveriided	зимняя одежда
talveunes olema	быть в спячке
talvine	зимний
tamm	дуб
täna	сегодня
täna hommikul	сегодня утром
täna õhtul	сегодня вечером
täna päeval	сегодня днём
tänav	улица
tänavalatern	фонарь (уличный)
tänavaliiklus	уличное движение
tangid	клещи
tango	танго
tangud	крупа
tank	танк
tanker	танкер
tankima	заправить (машину)
tankla	автозаправка
tankla	бензозаправка
tankla	бензоколонка
Tansaania	Танзания
tants	танец
tantsija	танцор
tantsijanna	танцовщица
tantsima	танцевать
tänu ...	благодаря ...
tänulik	благодарный
tapeet	обои
tapeeti panema	оклеить обоями
tapetu	убитый (сущ.)
tapma	убивать
tapma	убить
täpne	пунктуальный
täpne	точный
täpselt	точно
täpselt kell kolm	ровно в 3 часа
tara	забор
tara	ограждение
tarakan	таракан
tarbija	потребитель
tariif	тариф
täring	фишка
täringumäng	игра в кости
tark	умный
tarkvara	программное обеспечение
tarnija	поставщик
tarvis olema	требоваться
tarvis olema	требоваться (быть нужным)
tarvitama	употребить
tasane	ровный (о поверхности)
tase	уровень (напр. масла)
tase	уровень(напр. масла)
tasku	карман
tasku-	карманный
taskulamp	фонарь (ручной)
taskunuga	карманный нож
taskurätik	носовой платок
taskuvaras	карманный воришка
Tasmaania	Тасмания
tass	чашка
tasuta	бесплатно
tasuta	бесплатный
tatar	гречиха
tätoveering	татуировка
tavaline	обыкновенный
tavaliselt	обычно
teada saama	узнавать (адрес и т.п.)
teade	сообщение
teadete agentuur	информационное агентство
teadete büroo	справочное бюро
teadetetabloo	информационное табло
teadlane	учёный
teadma	знать (что-л.)
teadus	наука
teaduskond	факультет
teaduslik	научный
teaduslik kraad	учёная степень
teaduslik töö	исследование (научн. труд)
teadvus	сознание (мед.)
teadvust kaotama	упасть в обморок
teatama	объявлять
teatama	сообщать (~ новость)
teater	театр
teatmik	справочник
teave	информация
teavitama	информировать
teavitama	уведомить
teder	тетерев
tee	дорога
tee	путь
tee (jook)	чай
teejuht	путеводитель
teekaaslane	попутчик
teekann	чайник (для заварки)
teelusikas	чайная ложка
teema	тема
teener	слуга
teenija	служанка
teenima	служить (рел.)
teenus	услуга
teeperv	обочина
teesalong	чайный салон
teesõel	ситечко (для чая)
tegema	делать
tegema	создать
tegusõna	глагол
tegutsema	действовать (поступать)
tegutsev vulkaan	действующий вулкан
tehas	завод
tehing	сделка
teine koht	второе место
teiseks	во-вторых
teisipäev	вторник
teivashüpe	прыжки с шестом
tekk	одеяло
tekk	палуба
teksapüksid	ДЖИНСЫ
tekst	текст
telefon	телефон
telefon heliseb	звонить (о телефоне)
telefon iputka	телефонная будка
telefoniraamat	телефонная книга
telefonitoru	трубка (телефонная)
telereklaam	телереклама
telesaade	телепередача
teleskoop	телескоп
televaataja	телезритель
televiisor	телевизор
televisioon	телевидение
telik	шасси
telk	палатка
tellija	заказчик
tellija	подписчик
tellima	заказать (блюдо)
tellima	заказывать
tellima	заказывать (в ресторане)
tellima	подписаться (на газету)
tellimine	подписка
tellimus	заказ
tellimusavaldus	заявка
tellingud	строительные леса
telliskivi	кирпич
tema	он
tema	она
temperatuur	температура
tempo	темп
tennis	теннис
tennisemängija	теннисист
tenniseväljak	корт
tenniseväljak	теннисный корт
teooria	теория
teoreem	теорема
teos	произведение
teos	сочинение (литер.)
teos	сочинение (муз.)
teras	сталь
teras-	стальной
terav	острый (нож и т.п.)
teraviljad	зерновые растения
teritama	точить
terrass	терраса
territoorium	территория
terve	здоровый
terve	целый (невредимый)
terve	целый (полностью)
terve aasta	целый год
terve kuu	весь месяц
terve kuu	целый месяц
terve ööpäev	круглые сутки
terve päev	весь день
terveks saama	выздоравливать
tervis	здоровье
testament	завещание (документ)
Thames	Темза
tibutama	моросить
tigu	улитка
tihane	синица
tihe	густой (туман)
tihe	плотный (напр. туман)
tihend	прокладка
tihnik	чаща
tiib	крыло
tiibklaver	рояль
tiiger	тигр
tiigrikutsikas	тигрёнок
tiik	пруд
tiitelleht	титульный лист
tiitrid	титры (имена актеров)
tiivad	крылья
tikkima	вышивать
tikkimine	вышивка
tikud	спички
tikutoos	спичечный коробок
tilk	капля
tilkuma	капать
till	укроп
tina	олово
tingimus	условие
tingimus	условие (договора)
tipp	вершина
tipptund	часы пик
tiraaž	тираж (газеты, журнала)
tiraaž	тираж (книги)
tisler	столяр
Tjan-Šan	Тянь-Шань
toatüdruk	горничная
tõde	истина
tõde	правда
tõeline	настоящий (момент)
tõenäoline	вероятный
tõenäoliselt	вероятно
tõend	удостоверение
tõestama	доказывать
tõestus	доказательство
toetama	поддержать (предложение)
tohutu	огромный
toiduained	продукты
toidunõud	посуда
toidupood	бакалея
toimetaja	редактор
tõke	преграда
tõkestama	перегородить (дорогу)
Tokio	Токио
tõkkepuu	шлагбаум
tõlge	перевод
tõlge	перевод (с другого языка)
tõlge	перевод (текст)
tõlk	переводчик
tõlk	переводчик (устный)
tõlkima	переводить
tõlkima	переводить (текст)
tõlkimine	перевод (процесс)
toll	дюйм
toll	таможня
tolliametnik	таможенник
tollilõiv	таможенная пошлина
tolm	ПЫЛЬ
tolmu pühkima	вытирать пыль
tolmuimeja	пылесос
tolmuimejaga koristama	пылесосить
tolmune	пыльный
tomat	помидор
tõmbama	тянуть (верёвку и пр.)
tõmblukk	молния (застежка)
tõmmu	смуглый
tonn	тонна
töö	работа
toodang	продукция
toode	продукт
tööintervjuu	собеседование
töökindel	надёжный (механизм)
töökoht	должность
tool	стул
tööline	рабочий
toon	тон
toonekurg	аист
tööpäev	рабочий день
tööpuudus	безработица
tooraine	сырьё
toores	сырой (не варёный)
tööriietus	рабочая одежда
tööriist	инструмент
tööriist	орудие труда
tööriistad	инструменты
toost	тост
tööstus	промышленность
tööstuslik	промышленный
töötaja	сотрудник
töötama	работать
tõotama	клясться
töötasu	заработная плата
töötasu	зарплата
tootja	производитель
tootma	производить
tootmine	производство (завод и т.п.)
töötu	безработный (сущ.)
tõotus	клятва
topis	чучело
torkama	уколоть (поранить)
torm	буря
torm	буря, шторм
torn	башня
tornaado	торнадо
Toronto	Торонто
torpeedo	торпеда
tort	торт
toru	труба
toru	трубка
toru hargile panema	положить трубку
toru hargilt võtma	снять трубку
torulukksepp	сантехник
tõsiasi	факт
tõsielufilm	документальный фильм
tosin	дюжина
tõsine	серьёзный
tossud	кроссовки
tõstetav värav	подъёмная решётка
tõstma	поднимать
tõstuk	подъёмник
tõug	порода
tõuge	толчок (подземный)
tõuk	гусеница
tõuk	червь (личинка)
tõukama	толкать
tõus	прилив
tõusma	ВЗОЙТИ
tõusurada	взлётная полоса
traav	рысь
traavima	рысью
traditsioon	традиция
trahv	штраф
trahvima	штрафовать
traksid	подтяжки
traktor	трактор
tramm	трамвай
transformeerima	трансформировать
transiit	транзит
transpordikompanii	транспортная компания
trapets	трапеция
trapp	трап
trauma	травма
treener	тренер
treenima	тренировать
treenima	тренировать (кого-л.)
treenima	тренироваться
treening	тренинг
treial	токарь
trellpuur	дрель
trenazöör	тренажёр
trend	тенденция
trenn	тренировка
trepikoda	подъезд
trepp	лестница
treppredel	стремянка
tribüün	трибуна (стадиона)
triikima	гладить (утюгом)
triikimislaud	гладильная доска
triikraud	утюг
trikid	специальные эффекты
trikk	трюк
trikoo	купальник
trio	трио
tripp	вешалка (петля)
trofee	трофей
troll	троллейбус
tromb	смерч
trompet	труба
trükiviga	опечатка
trükk	издание
trumlit keerutama	вращать барабан
trumm	барабан
trümm	трюм
trump	козырь
trupp	труппа
truu	верный
truudus	верность
tsaar	царь
tsaarinna	царица
T-särk	футболка
Tšau-tšau	чау-чау
tsehh	цех
tšello	виолончель
tsellofaan	целлофан
tsement	цемент
tšempion	чемпион
Tšiili	Чили
tšiili	чилийский
tšiilitar	чилийка
tšiillane	чилиец
tsink	цинк
tšintšilja	шиншилла
tsirkus	цирк
tsistern	цистерна
tsiteerima	цитировать
tsiviil-	гражданский
tsivilisatsioon	цивилизация
tsoon	зона
tsükkel	цикл
tsüklon	циклон
tsunami	цунами
tualett	туалет
tuba	комната
tuba kinni panema	бронировать номер
tubakas	табак
tuberkuloos	туберкулёз
tüdruk	девочка
tugev	могущественный
tugev	сильный
tugev	сильный (дождь)
tugitool	кресло
tuharad	ягодицы
tuhatoos	пепельница
tühi	пустой (~ бокал)
tühine	незначительный
tühjaks minema	разрядиться
tühjaks minema	спустить (о колесе)
tühjaks saama	сесть (о батарейке)
tuhk	пепел
tuisk	вьюга
tukk	чёлка
tükk	кусок
tükk	обломок
tükk	штука
tuld kustutama	погасить свет
tulekahju	пожар
tulekustuti	огнетушитель
tulemus	результат
tuletõrjuja	пожарный
tulevane	будущий
tulevik	будущее (сущ.)
tuli	огонь
tuli	шах
tüli	ссора (перебранка)
tulirelv	огнестрельное оружие
tulistama	выстрелить
tulistama	стрелять
tulistamine	стрельба
tülitama	мешать (беспокоить)
tülitsema	ссориться
tulnukas	пришелец
tulp	тюльпан
tulu	доход
tume	тёмный
tumm	немой
tummfilm	немое кино
tund	урок
tund	час
tundma	знать (кого-л.)
tundma	чувствовать(опасность)
tundmatu	неизвестный
tundra	тундра
Tuneesia	Тунис
tuneesia	тунисский
tuneeslane	тунисец
tuneeslanna	туниска
tungraud	домкрат
tünn	бочка
tunnel	тоннель
tunni aja pärast	через час
tunni ajajooksul	в течение часа
tunnimees	часовой (воен.)
tunnistaja	свидетель
tuntud	известный
türann	тиран
turbiin	турбина
turg	рынок
türgi	турецкий
Türgi	Турция
turism	туризм
turist	турист
türkiissinine	бирюзовый
türklane	турок
türklanna	турчанка
turkmeen	туркмен
turkmeeni	туркменский
turkmeenlanna	туркменка
Türkmenistan	Туркменистан
tursk	треска
turuosa	сегмент рынка
turu-uurimine	маркетинг
turvamees	охранник
turvas	торф
turvavöö	ремень безопасности
turvavööd kinni panema	пристегнуть ремень
tušš	тушь
tütar	дочь
tütarlaps	девушка
tuttav	знакомый (сущ.)
tutvustama	познакомить
tuub	тюбик
tüüfus	тиф
tuuleklaas	ветровое стекло
tuulevaikus	штиль
tuuma-	ядерный
tuumarelv	ядерное оружие
tuunikala	тунец
tüüp	тип
tüür	штурвал
tuurakala	осётр
tuurakala	осетрина
tüürimees	штурман
tuvi	голубь
tüvi	ствол (дерева)
tuvila	голубятня
udu	туман
udulaternad	противотуманные фары
udune	туманный
üheaegselt	одновременно
üheinimesetuba	одноместный номер
üheksa	девять
ühendama	объединять
ühendama	подсоединить
ühendama	соединить (по телефону)
ühesugune	одинаковый
ühesuunalisele teele	одностороннее движение
ühine	совместный
ühiskajut	кают-компания
ühiskond	общество
ühiskondlik	общественный
uhke	гордый
uhkus	гордость
uhkust tundma	гордиться
ühtesobiv	совместимый
uhtuja	омыватель
uhtuma	омывать
uim	плавник
uisud	коньки
uisutama	кататься
uisutama	кататься на коньках
ujuja	пловец
ujuma	плавать
ujumine	плавание
ujumismadrats	плавательный матрац
Ukraina	Украина
ukraina	украинский
ukrainlane	украинец
ukrainlanna	украинка
uks	дверь
üks	один
uksed	дверца
uksehing	петля (дверная)
uksehoidja	портье
uksekell	звонок (прибор)
uksekella helin	звонок (звук)
ukselink	ручка (двери)
ukselink	ручка (дверная)
uksematt	коврик
uksesilm	глазок
üksikasi	подробность
üksikasjad	детали (подробности)
üksikasjalik	подробный
üksikasjalikult	подробно
üldriiklik tee	национальная дорога
üle andma	передать (подарок и т.п.)
üle kuulama	допрашивать
üle kuumenema	перегреться
üle tänava minema	переходить (улицу)
üle ujutama	затопить (залить водой)
üle ujutama	разливаться
ülearune	чрезмерный
üleeile	позавчера
ülehelikiiruse	сверхзвуковой
ülehomme	послезавтра
ülejäänud	остальное
ülekäigurada	пешеходный переход
ülekäik	пешеходный переход
ülekuulamine	допрос
ülemaailmne	мировой (всемирный)
ülemus	начальник
üleriided	верхняя одежда
üles kasvatama	выращивать
üles kirjutama	записывать
üles tõusma	вставать (с постели)
üles tõusma	подниматься (утром)
ülesanne	задание (воен.)
ülesanne	задача
ülesõit	переезд
ülesvoolu	вверх по течению
üleujutus	наводнение
üleval	наверху
ulg	вой
ulguma	выть
ulguma	рыдать
ülikond	костюм (мужской)
ülikool	университет
ülikoolilõpetaja	выпускник (вуза)
üliõpilane	студент
üliõpilane	студентка
üllatama	удивлять
üllatav	удивительный
ümber hindama	переоценивать
ümber kirjutama	переписать (файл)
ümber paigutama	передвигать (в другое место)
ümber piirama	окружать
ümber piirama	осаждать
ümber pöörama	перевернуть (напр. камень)
ümber pöörama	разворачиваться
ümber riietuma	переодеваться
ümber tegema	переделывать
ümbermõõt	периметр
ümberpiiramine	окружение
ümberpiiramine	осада
ümberpiiratud	осаждённый
ümberringi	вокруг
umbes	около (~ 10 кг)
umbes kell neli	около 4-х часов
ümbrik	конверт
umbrohi	сорняк
ümbrus	окрестности
umbtänav	тупик
umbusaldus	недоверие
umbusklik	недоверчивый
ümmargune	круглый
ummistuma	засориться
und nägema	видеть сны
undama	гудеть (гудок, поезд)
unenägu	сон (сновидения)
unerohi	снотворное
unerohtu võtma	принять снотворное
unetu	бессонный
unetus	бессонница
ungari	венгерский
Ungari	Венгрия
ungarlane	венгр
ungarlanna	венгерка
uni	сон
uni	сон (состояние)
unine	сонный
unistama	мечтать
universum	мир, вселенная
unts	унция
unustama	забывать
unustama	забыть
uppuma	затонуть (о корабле)
uppuma	тонуть
uppuma	тонуть (о корабле)
uppuma	тонуть (о человеке)
uputama	затоплять
Uraan	Уран
urg	нора
ürgne	первобытный
urisema	рычать
urn	погребальная урна
Uruguai	Уругвай
usaldama	верить (доверять)
usaldama	доверять
usaldav	доверчивый
usaldus	доверие
usaldusväärne	надёжный (партнёр)
usbeki	узбекский
Usbekistan	Узбекистан
usbekitar	узбечка
usbekk	узбек
usk	верование
usklik	верующий (сущ.)
usklikud	верующий (сущ.)
uskuma	верить
üsna lihtne	нетрудный
uss	змея
ussipoeg	змеёныш
ütlema	сказать
uudis	новость
uudishimu	любопытство
uudishimulik	любопытный
uuelt realt	с новой строки
uuesti	заново
Uurali mäed	Уральские горы
uurija	исследователь
uurija	следователь
uurima	изучать
uurima	исследовать
üürima	снимать (~ квартиру)
üürima	снимать (напр. квартиру)
uurimine	исследование (поиск)
uurimine	расследование
uus	новый
Uus Meremaa	Новая Зеландия
Uus Testament	Новый Завет
uusmeremaa	новозеландский
uusmeremaalane	новозеландец
uusmeremaalanna	новозеландка
vaaderpass	уровень (инструмент)
vaal	КИТ
vaalapüügilaev	китобойное судно
vaalapüük	китобой
vääramatu jõud	форс-мажор
vaarao	фараон
vaarikas	малина
vaarikpunane	малиновый
vääris lõhe	сёмга
väärt olema	заслуживать
väärtesemed	драгоценности
väärtuslik	драгоценный (камень)
vaas	ваза
vaataja	зритель
vaatama	глядеть на ...
vaatama	смотреть
vaatama	смотреть (телевизор)
vaateaken	витрина
vaatetorn	вышка (строение)
vaba	свободный
vabadus	свобода
vabalt	свободно
Vabalt!	Вольно!
vabandama	извиняться
vabandus	извинение
vabariik	республика
vabariiklane	республиканец
vabariiklik erakond	республиканская партия
vabastama	освободить (из тюрьмы)
vabastama	освобождать (город)
vabatahtlik	доброволец
vabrik	фабрика
vaene	бедный
vaenlane	враг
vaenulik	враждебный
vaenulik	вражеский
väetama	удобрять
väetis	удобрение (вещество)
vaevalt	вряд ли
väga	очень
vagel	червь
vägi	войско
vägivald	насилие
vagu	борозда
vaheaeg	перерыв
vahekäik	проход (между креслами)
vahekohtunik	рефери
vahel	между
väheldane	небольшой
vahele panema	вставлять
vahele segama	вмешиваться
vahele segama	смешивать
vahelejätmine	пропуск (отсутствие)
vahemaa	отрезок(пути)
vahemaa	расстояние
vahend	СНарЯД (спорт.)
vahend	средство (мед.)
vähendama	сократить (расходы)
vähendama	уменьшать
vaher	клён
vaherahu	перемирие
vahetama	заменить (игрока)
vahetama	менять
vahetund	перемена
vahetus	замена
vahetus	обмен
vähk	рак
vaht	пена
vahvlid	вафли
vai	свая
vaidlema	спорить
vaidlus	спор
vaidlus	спор (дебаты)
väike	маленький
väike sõrm	мизинец
väikebuss	микроавтобус
väikelaps	малыш
vaikima	молчать
vaikima	промолчать
vaikimine	молчание
vaikne	тихий (негромкий)
vaikne	тихий (спокойный)
Vaikne ookean	Тихий океан
vaikus	тишина
vaim	ДУХ
väimees	зять
vaimuhaige	сумасшедшая (сущ.)
vaimuhaige	сумасшедший (сущ.)
vaimulik	священник
vaimustuma	восхищаться
väin	пролив
vaip	ковёр
vait jääma	замолчать
väitekiri	диссертация
vajadus	потребность
vajalik	необходимый
vajalik	нужный
vajalik olema	требоваться (быть необходимым)
vakants	вакансия
vaktsineerima	делать прививки
vaktsineerima	делать прививку
vaktsineerimine	прививка
valama	наливать (в чашку)
valdama	владеть
vale	неправильный (ошибочный)
valetama	врать
valge	белый
valged	белые
valgendama	белить
valgevask	латунь
valgud	белки
välgumihkel	зажигалка
valgusfoor	светофор
valgusti	светильник (на стене)
vali	громкий
vali	громкий (голос)
valija	избиратель
valik	ассортимент
valik	выбор (ассортимент)
valik	подбор
valima	выбирать
valima	выбирать, избирать
valima	выбрать
valimised	выборы
valimiskampaania	избирательная кампания
väline	внешний
välismaal	за границей
välismaalane	иностранец
välismaine	иностранный
välisreklaam	наружная реклама
välistrepp	крыло (здания)
välistrepp	крыльцо
valitseja	правитель
valitsus	правительство
valitud teosed	избранное
välja andma	издавать (книгу)
välja hingama	выдохнуть
välja kannatama	терпеть (боль и т.п.)
välja kirjutama	прописать (лекарство)
välja lülitama	выключать
välja lülitama	выключить
välja lülitama	отсоединить
välja lülitama	тушить (свет)
välja minema	выйти (из дома и т.п.)
välja õpetama	объезжать (лошадь)
välja pressima	вымогать
välja surema	вымереть (динозавры)
välja surema	глохнуть (о моторе)
välja tulema	выходить (из дома)
välja valima	отобрать (выбрать)
välja vedama	экспортировать
valjad	уздечка
väljahingamine	выдох
väljak	площадь
väljakaevamised	раскопки (место работ)
väljakaevamised	раскопки (работы)
väljalend	вылет
väljalend hilineb	задержка вылета
väljalennuaeg	время вылета
väljapressija	вымогатель
väljapressija	рэкетир
väljapressimine	вымогательство
väljavedaja	экспортёр
väljend	выражение
väljend	фраза
väljendama	выразить (словами)
valjusti	вслух
valjusti	громко
välk	молния
välku lööma	сверкать
vallaline	холостой
vallaline	ХОЛОСТОЙ (прил.)
vallandama	уволить
vallandamine	увольнение
vallikraav	ров
vallutaja	завоеватель
vallutama	завоевать
vallutama	покорять
valm	басня
valss	вальс
valu	боль
valuuta	валюта
valuvaigisti	обезболивающее
valvama	охранять (природу)
valve	охрана
Valvel!	Смирно!
valvur	сторож
vampiir	вампир
vana	старый
vana	старый (дом и т.п.)
Vana Testament	Ветхий Завет
vanaaegne	старинный
vanaeit	старая женщина
vanaema	бабушка
vana-inglise lambakoer	бобтейл
vanaisa	дедушка
vanamees	старик
vanapoiss	ХОЛОСТЯК
vanasõna	пословица
vandemees	присяжные
vandemeeste kohus	суд присяжных
vandenõu	заговор
vanem poeg	старший сын
vanem tütar	старшая дочь
vanemad	родители
vang	заключённый
vangerdus	рОКИрОВКа (шахм.)
vangi sattuma	попасть в плен
vangi võtma	взять в плен
vangikong	камера
vangis olema	быть в плену
vangist põgenema	бежать (из плена)
vangistus	плен
vangivalvur	надзиратель
vangla	тюрьма
vanker	ладья
vann	ванна
vannitama	купать
vannitoaga	с ванной
vannituba	ванная комната
vanus	возраст
vappekülm	озноб
vapper	отважный
vapper	храбрый
vara	рано (~ проснуться)
varaan	варан
varahommik	раннее утро
varakult	заранее
varas	вор
varastama	воровать, красть
varastama	красть
värav	ворота
värav	гол
väravat lööma	забить гол
väravavaht	вратарь
väravpall	гандбол
varblane	воробей
varemed	руины
vares	ворона
vargus	воровство, кража
variant	вариант
varing	обвал (снежный)
värisema	дрожать
varistus	засада
varjuma	скрыться
varjund	оттенок
varn	вешалка (на стене)
varrukas	рукав
vars	стебель
värske	свежий
värske	свежий (напр. журнал)
varss	жеребёнок
Varssavi	Варшава
varsti	скоро
varumängijate pink	скамейка запасных
varuosa	запчасть
värv	краска
värv	цвет
värvima	красить
vasak	левый
vasakul	слева
vasakule	налево
vasall	вассал
vasikaliha	телятина
vasikas	телёнок
väsima	уставать
väsinud	усталый
väsitama	утомлять
väsitav	утомительный
vask	медь
vaskne	медный
vastama	ответить
vastama	отвечать
vastandlik	противоположный
vastane	противник
vastne	личинка
vastu vaidlema	возражать
vastu võtma	принять (согласиться)
vastupidav	крепкий
vastupidav	прочный
vastus	ответ (на вопрос)
vastutama	ответственный
vastutus	ответственность
vastuvõtmist tõendav allkiri	расписка
Vatikan	Ватикан
vatt	вата
vedamine	удача (везение)
vedel	жидкий
vedru	пружина
veduk	тягач
vedurijuht	машинист
vee all	под водой
veebi lehekülg	веб-сайт
veebi lehekülg	веб-страница
veebimeister	веб-мастер
veebruar	февраль
veehoidla	водохранилище
veekeeris	водоворот
veekeetja	чайник (для кипятка)
veekindel	непромокаемый
veekogu	водоём
veen	вена
veenma	убеждать
veenma	уговорить
Veenus	Венера
veepall	водное поло
veerand tundi	четверть часа
veerima	говорить по буквам
veesuusad	водные лыжи
Veevalaja	Водолей
vehkleja	фехтовальщик
vehklemine	фехтование
veinikaart	карта вин
veiniklaas	бокал
veinimeister	винодел
veksel	вексель
velotrenazöör	велотренажёр
veluurist	велюровый
velvet	вельвет
vend	брат
vene	русский
Veneetsia	Венеция
venelane	русский (сущ.)
venelanna	русская (сущ.)
Venemaa	Россия
Venetsueela	Венесуэла
vennapoeg	племянник
vennatütar	племянница
ventiil	вентиль
ventilaator	вентилятор
veo lift	грузовой лифт
veoauto	грузовик
veorattad	ведущие колёса
veranda	веранда
verejooks	кровотечение
veri	кровь
versioon	версия
vertikaalne	вертикальный
vesi	вода
vesiir šahh šeih	визирь шах шейх
vesiroos	кувшинка
vesivelo	водный велосипед
veski	мельница
vest	жилет
vestibüül	вестибюль
vestlema	беседовать
vestlus	беседа
vestlus	разговор
vestluskaaslane	собеседник
vestmik	разговорник
vibu	лук
vibulaskmine	стрельба из лука
videokaamera	видеокамера
videokassett	видеокассета
videomagnetofon	видеомагнитофон
videoprojektor	видеопроектор
Vietnam	Вьетнам
vietnami	вьетнамский
vietnamlane	вьетнамец
vietnamlanna	вьетнамка
viga	ошибка
vigane	калека
vigastama	повредить (испортить)
vigastus	повреждение
vigastus	повреждение (рана)
vigastus	ущерб
vigla	вилы
vigu tegema	делать ошибки
viha	ненависть
vihale ajama	рассердить
vihane	злой (сердитый)
vihane	сердитый
vihastama	злиться
vihastama	сердиться (на ...)
vihik	тетрадь
vihjama	намекать
vihjama	подсказать (отгадку)
vihje	намёк
vihkama	ненавидеть
vihm	дождь
vihma sajab	идёт дождь
vihmamantel	плащ
vihmane	дождливый
vihmavari	зонт
viik	ничья
viiki mängima	сыграть вничью
viikingid	викинги
viil	ломтик
viil	напильник
viimane	последний
Viin	Вена
viinamarjad	виноград
viinamarjaistandus	виноградник
viiner	сосиска
viirastus	призрак
viirus	вирус
viis	мелодия
viis	способ
viis tärni	5 звёзд
viisa	виза
viisakas	вежливый
viisteist minutit	15 минут
viiul	скрипка
vikaar	викарий
vikat	коса (орудие)
vikerkaar	радуга
vile	гудок (фабричный)
vile	свист
vili	ЗерНО (собират.)
vilistama	свистеть
vilja jahvatama	молоть (зерно)
viljad	зерновые (сущ.)
viljakas	плодородный
vill	шерсть
villa	вилла
villane	шерстяной
viltpliiats	фломастер
vineer	фанера
vinguma	визжать
vinguma	жужжать
vinn	курок (спусковой крючок)
vint	винт
vint	резьба (на винте)
violetne	фиолетовый
virsik	персик
visand	набросок
vise	бросок (хокк.)
visiir	забрало
visiit	визит
visiitkaart	визитная карточка
vist	наверное (вероятно)
vitamiin	витамин
vitraaž	витраж
vitriin	витрина
või	или
või	сливочное масло
võib olla	может быть
võibolla	может быть
võid	можешь
võidusõitja	гонщик
võileib	бутерброд
võilill	одуванчик
võim	власть
võima	мочь
võimalik	возможно
võimalik	возможный
võimas	могущественный
võimatu	невозможно
võimatu	невозможный
võimed	способность (к чему-л.)
võimendi	усилитель
võimleja	гимнаст
võimlemine	гимнастика
võimlemiskang	перекладина
võimsus	мощность
võimud	власти
võistlus	бой (в боксе)
võit	выигрыш
võit	победа
võitja	победитель
võitlema	сражаться
võitlus	сражение
võitma	выиграть
võitma	победить
võitma	побеждать
võitoos	маслёнка
võiv	арка
võlg	долг
Volga	Волга
võlgnik	должник
võlgu andma	дать в долг
võlgu võtma	взять в долг
võllas	виселица
volt	вольт
võltsima	подделывать
võltsing	подделка (понятие)
võltsitud	фальшивый
võlu-	волшебный
võlukepike	волшебная палочка
võluma	очаровывать
võlur	волшебник
võlur	волшебница
vöö	пояс (ремень)
voodi	кровать
voodikate	покрывало
voodilina	простыня
voodipesu	постельное бельё
voodit üles tegema	стелить постель
vool	течение
vool	ток
voolutugevus	сила тока
vöör	нос (корабля)
võõra planeedi asukas	инопланетянин
võõrasema	мачеха
võõrasemad	анютины глазки
võõrasisa	отчим
võõrkeel	иностранный язык
võpatama	вздрагивать
võrdlema	сравнивать
võrdlus	сравнение
võrguga püüdma	ловить сетью
võrk	сетка
võrk	сеть
võrk	сеть (дистрибьюторов)
võrkpall	волейбол
võrkpallur	волейболист
võrku välja tõmbama	вытаскивать сеть
võrku vette heitma	забрасывать сеть
vorm	форма (внешний вид)
vormiriietus	обмундирование
vormiriietus	униформа
vormiriietus	форма (униформа)
vorst	колбаса
võti	ключ
võtma	брать
võtma	ВЗЯТЬ
võtma	нанимать (напр. лодку)
võtmekimp	связка (ключей)
võttegrupp	съёмочная группа
võtteplats	съёмочная площадка
vulkaan	вулкан
vulkaanipurse	извержение
vundament	фундамент
vuntsid	усы
vurrud	усы (у животных)
vürts	пряность
vutlar	футляр
vutt	перепел
Washington	Вашингтон
WC-pott	унитаз
Zambezi	Замбези
žest	жест
žongleerima	жонглировать
žonglöör	жонглёр
zookauplus	зоомагазин
zooloog	зоолог
žürii	жюри
Маа	Земля